Citalopram	drug	
Morphine	drug	
cardiac event	phenotype	
HSD11B1	drug_target	
UGT1A1	drug_target	
ADRB3	drug_target	
CHRM3	drug_target	
S100B	drug_target	
LTA4H	drug_target	
CREB1	drug_target	
FKBP1A	drug_target	
SLC22A3	drug_target	
HTR3A	drug_target	
GABRG1	drug_target	
Hyaluronidase	drug	
CYP3A5	drug_target	
SMPD1	drug_target	
CYP3A43	drug_target	
KCND3	drug_target	
HTR2A	drug_target	
GABRP	drug_target	
HTR1B	drug_target	
PCYT1B	drug_target	
CACNB1	drug_target	
ANXA1	drug_target	
ADRA1A	drug_target	
ABCB1	drug_target	
CHRM5	drug_target	
SLC22A2	drug_target	
CACNA1C	drug_target	
Fluoxetine	drug	
MPO	drug_target	
PLD2	drug_target	
Amantadine	drug	
UGT1A8	drug_target	
PAH	drug_target	
SLC44A2	drug_target	
Tacrolimus	drug	
ACE	drug_target	
CYP17A1	drug_target	
ADRA2A	drug_target	
GRIA1	drug_target	
NOS2	drug_target	
UGT2B4	drug_target	
ABCC3	drug_target	
MT-ND1	drug_target	
SLC44A4	drug_target	
ADRA2C	drug_target	
Chlorpromazine	drug	
Modafinil	drug	
HTR2C	drug_target	
MAOA	drug_target	
GSTP1	drug_target	
UGT1A3	drug_target	
KCNJ11	drug_target	
HRH4	drug_target	
Simeprevir	drug	
SLC16A2	drug_target	
OPRK1	drug_target	
SLC22A6	drug_target	
Thioridazine	drug	
SLC44A3	drug_target	
GRIN1	drug_target	
Diazepam	drug	
THRA	drug_target	
NR0B1	drug_target	
ATP2C1	drug_target	
SLC6A2	drug_target	
Levothyroxine	drug	
ABCB11	drug_target	
ABCG2	drug_target	
GABRR2	drug_target	
CACNA1B	drug_target	
SPTBN1	drug_target	
Loperamide	drug	
SHBG	drug_target	
CYP2E1	drug_target	
HTR6	drug_target	
CYP2C18	drug_target	
Memantine	drug	
Naloxone	drug	
GABRA2	drug_target	
GABRA5	drug_target	
GABRB3	drug_target	
ABCC1	drug_target	
SLC10A1	drug_target	
SLC22A4	drug_target	
Erythromycin	drug	
Phenytoin	drug	
TNNC2	drug_target	
HTR1E	drug_target	
GLRA1	drug_target	
CACNA1S	drug_target	
CEPT1	drug_target	
FMO3	drug_target	
SLCO4A1	drug_target	
MLNR	drug_target	
Pergolide	drug	
CYP3A4	drug_target	
ADRA1B	drug_target	
Sotalol	drug	
CYP2C9	drug_target	
AR	drug_target	
SLC5A7	drug_target	
SLCO1C1	drug_target	
HTR1F	drug_target	
XDH	drug_target	
CYP1A1	drug_target	
Oxycodone	drug	
CYP2C8	drug_target	
RYR1	drug_target	
ESR1	drug_target	
Droperidol	drug	
ABCC4	drug_target	
PHOSPHO1	drug_target	
S100A4	drug_target	
TNNC1	drug_target	
CALY	drug_target	
CYP1B1	drug_target	
MMP2	drug_target	
UGT1A4	drug_target	
GABRA1	drug_target	
ATP5D	drug_target	
Clozapine	drug	
CYP2D6	drug_target	
GABRQ	drug_target	
OPRM1	drug_target	
CHDH	drug_target	
COMP	drug_target	
CHRM4	drug_target	
Calcium	drug	
NR3C1	drug_target	
Levorphanol	drug	
TSPO	drug_target	
DRD1	drug_target	
Methadone	drug	
GABRG2	drug_target	
CYP2B6	drug_target	
CACNA1F	drug_target	
KCNH2	drug_target	
ABCA5	drug_target	
SLC44A1	drug_target	
Cardiac arrest	phenotype	
THRB	drug_target	
Atropine	drug	
CHRM1	drug_target	
SLCO1B3	drug_target	
CYP4A11	drug_target	
Clomipramine	drug	
DRD4	drug_target	
KCND2	drug_target	
DRD2	drug_target	
CACNA1D	drug_target	
Menthol	drug	
Fosphenytoin	drug	
Trazodone	drug	
Choline	drug	
MAOB	drug_target	
Testosterone	drug	
Disopyramide	drug	
Sufentanil	drug	
SSTR5	drug_target	
HRH1	drug_target	
CYP11A1	drug_target	
HTR1A	drug_target	
PTGS1	drug_target	
RYR2	drug_target	
ADRB1	drug_target	
Fluphenazine	drug	
CAST	drug_target	
GABRB2	drug_target	
SLC6A4	drug_target	
POMC	drug_target	
CHAT	drug_target	
ABCC10	drug_target	
CACNB2	drug_target	
Alfentanil	drug	
Propranolol	drug	
SLC22A1	drug_target	
SLC6A3	drug_target	
SERPINA7	drug_target	
SLC22A8	drug_target	
ORM1	drug_target	
Trifluoperazine	drug	
GABRR1	drug_target	
SLCO1B1	drug_target	
UGT2B15	drug_target	
SSTR2	drug_target	
Octreotide	drug	
Verapamil	drug	
Prednisone	drug	
KCNA1	drug_target	
CACNA1I	drug_target	
DDC	drug_target	
SSTR1	drug_target	
DRD3	drug_target	
GRIN2B	drug_target	
TRPM8	drug_target	
Sumatriptan	drug	
ALB	drug_target	
GABRG3	drug_target	
ACHE	drug_target	
HTR1D	drug_target	
CHRM2	drug_target	
SLC7A5	drug_target	
HTR2B	drug_target	
PLD1	drug_target	
TLR4	drug_target	
CACNA1A	drug_target	
Isoflurane	drug	
TTR	drug_target	
GABRB1	drug_target	
CYP19A1	drug_target	
Tetracaine	drug	
Dexamethasone	drug	
Thiothixene	drug	
CACNB4	drug_target	
HTR7	drug_target	
TGFB1	drug_target	
CYP1A2	drug_target	
Captopril	drug	
Fentanyl	drug	
Nalbuphine	drug	
OPRD1	drug_target	
ADRB2	drug_target	
Promethazine	drug	
GABRD	drug_target	
MMP9	drug_target	
PCYT1A	drug_target	
CHKB	drug_target	
Remifentanil	drug	
CALM3	drug_target	
CYP2A13	drug_target	
CHKA	drug_target	
CACNA1G	drug_target	
TNF	drug_target	
UGT2B7	drug_target	
GRIN2A	drug_target	
ADRA1D	drug_target	
CACNB3	drug_target	
ADRA2B	drug_target	
ABCC2	drug_target	
BCHE	drug_target	
SLCO1A2	drug_target	
SCN5A	drug_target	
GRIN3A	drug_target	
CYP2C19	drug_target	
GABRA3	drug_target	
Epinephrine	drug	
CYP2A6	drug_target	
SLC22A5	drug_target	
DRD5	drug_target	
SCN1A	drug_target	
