CHRM3	drug_target	
HTR3A	drug_target	
SLC22A3	drug_target	
CYP3A5	drug_target	
Nortriptyline	drug	
KCND3	drug_target	
HTR2A	drug_target	
HTR1B	drug_target	
CHRNA2	drug_target	
Trimipramine	drug	
ADRA1A	drug_target	
ABCB1	drug_target	
CHRM5	drug_target	
SLC22A2	drug_target	
ADRA2A	drug_target	
UGT2B4	drug_target	
ADRA2C	drug_target	
HTR2C	drug_target	
MAOA	drug_target	
CHRNA3	drug_target	
Aripiprazole	drug	
Ziprasidone	drug	
OPRK1	drug_target	
GRIN1	drug_target	
Buspirone	drug	
SLC6A2	drug_target	
ABCG2	drug_target	
CYP2E1	drug_target	
HTR6	drug_target	
CYP2C18	drug_target	
CHRNA7	drug_target	
Memantine	drug	
CHRNA4	drug_target	
SLC22A4	drug_target	
HTR1E	drug_target	
Nefazodone	drug	
Safinamide	drug	
Pergolide	drug	
CYP3A4	drug_target	
ADRA1B	drug_target	
CYP2C9	drug_target	
CHRNB2	drug_target	
CYP1A1	drug_target	
Oxycodone	drug	
CYP2C8	drug_target	
Dronabinol	drug	
Cocaine delirium	phenotype	
Imipramine	drug	
Quetiapine	drug	
CYP2D6	drug_target	
SLCO3A1	drug_target	
OPRM1	drug_target	
CHRM4	drug_target	
PGRMC1	drug_target	
DRD1	drug_target	
CYP2B6	drug_target	
KCNH2	drug_target	
CHRM1	drug_target	
KCND2	drug_target	
DRD4	drug_target	
DRD2	drug_target	
MAOB	drug_target	
HRH1	drug_target	
HTR1A	drug_target	
PTGS1	drug_target	
SLC6A4	drug_target	
SLC22A1	drug_target	
SLC6A3	drug_target	
ORM1	drug_target	
DRD3	drug_target	
CNR2	drug_target	
GRIN2B	drug_target	
CHRNB4	drug_target	
SIGMAR1	drug_target	
ALB	drug_target	
CHRM2	drug_target	
HTR1D	drug_target	
HTR2B	drug_target	
Oxcarbazepine	drug	
HTR7	drug_target	
Dextromethorphan	drug	
CYP1A2	drug_target	
Fentanyl	drug	
OPRD1	drug_target	
UGT2B7	drug_target	
GRIN2A	drug_target	
ADRA1D	drug_target	
ADRA2B	drug_target	
CNR1	drug_target	
SCN5A	drug_target	
GRIN3A	drug_target	
CYP2C19	drug_target	
CYP2A6	drug_target	
DRD5	drug_target	
Codeine	drug	
