PTK6	drug_target	
PPARD	drug_target	
HRH2	drug_target	
CHRM3	drug_target	
GLUL	drug_target	
Lisinopril	drug	
ADORA2A	drug_target	
HTR3A	drug_target	
Hyaluronidase	drug	
CYP3A5	drug_target	
ABCC8	drug_target	
Eprosartan	drug	
PPARG	drug_target	
ACE2	drug_target	
SELE	drug_target	
SLC7A8	drug_target	
HTR1B	drug_target	
HTR2A	drug_target	
YARS	drug_target	
Bromocriptine	drug	
SRD5A1	drug_target	
Cerebral edema	phenotype	
Periorbital edema	phenotype	
PDE4A	drug_target	
ADRA1A	drug_target	
CHRM5	drug_target	
ABCB1	drug_target	
SLC22A2	drug_target	
Levocetirizine	drug	
MPO	drug_target	
UGT1A8	drug_target	
Insulin Detemir	drug	
Oxymetholone	drug	
ACE	drug_target	
AVPR1B	drug_target	
ADRA2A	drug_target	
Perindopril	drug	
ADRA2C	drug_target	
Cabergoline	drug	
Trandolapril	drug	
Modafinil	drug	
AGTR1	drug_target	
AOX1	drug_target	
ADORA1	drug_target	
HTR2C	drug_target	
Paliperidone	drug	
MAOA	drug_target	
HTR5A	drug_target	
PDE4B	drug_target	
Telmisartan	drug	
Pindolol	drug	
UGT1A3	drug_target	
Quinapril	drug	
SLC16A2	drug_target	
SLC22A6	drug_target	
KCNQ3	drug_target	
DBH	drug_target	
MTHFR	drug_target	
Diflunisal	drug	
SLC6A2	drug_target	
ABCG2	drug_target	
NT5E	drug_target	
SHBG	drug_target	
CYP2E1	drug_target	
HTR6	drug_target	
Ropinirole	drug	
CYP2C18	drug_target	
Facial edema	phenotype	
ABCC1	drug_target	
Epoprostenol	drug	
JUN	drug_target	
Phendimetrazine	drug	
Treprostinil	drug	
Erythromycin	drug	
High altitude pulmonary edema	phenotype	
HTR1E	drug_target	
Capsaicin	drug	
FMO3	drug_target	
MLNR	drug_target	
Pergolide	drug	
ADRA1B	drug_target	
CYP3A4	drug_target	
AVPR1A	drug_target	
SLCO1C1	drug_target	
CYP2C9	drug_target	
AR	drug_target	
XDH	drug_target	
CYP1A1	drug_target	
CYP2C8	drug_target	
AVPR2	drug_target	
Apomorphine	drug	
GJA1	drug_target	
Dexpanthenol	drug	
CALY	drug_target	
Ampicillin	drug	
SLC15A2	drug_target	
Pulmonary edema	phenotype	
Quetiapine	drug	
Levodopa	drug	
CYP2D6	drug_target	
KCNQ2	drug_target	
CHRM4	drug_target	
TRPV1	drug_target	
Desmopressin	drug	
Gatifloxacin	drug	
DRD1	drug_target	
CYP2B6	drug_target	
Meclofenamic Acid	drug	
KCNH2	drug_target	
SLC16A1	drug_target	
PTGIR	drug_target	
Ramipril	drug	
TAT	drug_target	
CHRM1	drug_target	
SLCO1B3	drug_target	
DRD4	drug_target	
DRD2	drug_target	
PTGIS	drug_target	
Pentoxifylline	drug	
SSTR5	drug_target	
HRH1	drug_target	
Infliximab	drug	
L-Tyrosine	drug	
Repaglinide	drug	
CES1	drug_target	
HTR1A	drug_target	
Pramipexole	drug	
PTGS1	drug_target	
Carvedilol	drug	
ADRB1	drug_target	
Aminocaproic Acid	drug	
SLC6A4	drug_target	
HRH4	drug_target	
Dicyclomine	drug	
SLC22A1	drug_target	
EGFR	drug_target	
SLC6A3	drug_target	
ORM1	drug_target	
PLAT	drug_target	
Fosinopril	drug	
SLCO1B1	drug_target	
SSTR2	drug_target	
Octreotide	drug	
Olmesartan	drug	
DDC	drug_target	
PTGS2	drug_target	
SSTR1	drug_target	
DRD3	drug_target	
Irbesartan	drug	
Cyproheptadine	drug	
Perphenazine	drug	
NPPB	drug_target	
FMO1	drug_target	
HIF1A	drug_target	
TEK	drug_target	
ALB	drug_target	
PDE5A	drug_target	
CHRM2	drug_target	
HTR1D	drug_target	
SLC7A5	drug_target	
HTR2B	drug_target	
INSR	drug_target	
TTR	drug_target	
Maprotiline	drug	
Cefaclor	drug	
HTR7	drug_target	
NDUFC2	drug_target	
TGFB1	drug_target	
CYP1A2	drug_target	
VCAM1	drug_target	
TH	drug_target	
ADRB2	drug_target	
P2RY12	drug_target	
PLG	drug_target	
YARS2	drug_target	
SLC16A10	drug_target	
CALM3	drug_target	
Vandetanib	drug	
TNF	drug_target	
ALOX5	drug_target	
ADRA1D	drug_target	
ADRA2B	drug_target	
ABCC2	drug_target	
BCHE	drug_target	
SLCO1A2	drug_target	
Loxapine	drug	
CYP2C19	drug_target	
Benazepril	drug	
SLC22A5	drug_target	
DRD5	drug_target	
VEGFA	drug_target	
Fenoprofen	drug	
