Citalopram	drug	
UGT1A1	drug_target	
IL2	drug_target	
SLCO2B1	drug_target	
PIK3CD	drug_target	
SI	drug_target	
CHRM3	drug_target	
ADORA2A	drug_target	
HTR3A	drug_target	
CYP3A5	drug_target	
PPARG	drug_target	
SCN10A	drug_target	
PRKDC	drug_target	
HTR2A	drug_target	
HTR1B	drug_target	
PDGFRA	drug_target	
CRBN	drug_target	
Donepezil	drug	
ADRA1A	drug_target	
ABCB1	drug_target	
CHRM5	drug_target	
SLC22A2	drug_target	
MPO	drug_target	
CSF1R	drug_target	
Pseudoephedrine	drug	
PIK3CA	drug_target	
UGT1A9	drug_target	
ADRA2A	drug_target	
UGT2B4	drug_target	
Nilotinib	drug	
ADRA2C	drug_target	
Cabergoline	drug	
FABP2	drug_target	
ADORA1	drug_target	
HTR2C	drug_target	
MAOA	drug_target	
GSTP1	drug_target	
PDE4B	drug_target	
UGT1A3	drug_target	
Diphenhydramine	drug	
ABL1	drug_target	
SLC22A6	drug_target	
Imatinib	drug	
Scopolamine	drug	
Acamprosate	drug	
SLC6A2	drug_target	
ABCG2	drug_target	
CYP2E1	drug_target	
Cevimeline	drug	
Ropinirole	drug	
CYP2C18	drug_target	
HTR6	drug_target	
ABCC1	drug_target	
HTR1E	drug_target	
FMO3	drug_target	
Paroxetine	drug	
CYP3A4	drug_target	
ADRA1B	drug_target	
Metoprolol	drug	
CYP2C9	drug_target	
Phenylephrine	drug	
CYP2C8	drug_target	
CYP1A1	drug_target	
RYR1	drug_target	
ABCC4	drug_target	
DDR1	drug_target	
CALY	drug_target	
CYP1B1	drug_target	
ABCA3	drug_target	
UGT1A4	drug_target	
Clozapine	drug	
CYP2D6	drug_target	
ATM	drug_target	
CHRM4	drug_target	
DRD1	drug_target	
CYP2B6	drug_target	
Nabumetone	drug	
FGFR2	drug_target	
PGD	drug_target	
Atropine	drug	
CHRM1	drug_target	
Clomipramine	drug	
DRD4	drug_target	
DRD2	drug_target	
Meloxicam	drug	
SLC22A11	drug_target	
NFKB1	drug_target	
HRH1	drug_target	
NTRK1	drug_target	
HTR1A	drug_target	
Pramipexole	drug	
PTGS1	drug_target	
ADRB1	drug_target	
HRH4	drug_target	
SLC6A4	drug_target	
PDGFRB	drug_target	
SLC22A1	drug_target	
EGFR	drug_target	
CFTR	drug_target	
SLC6A3	drug_target	
SLC22A8	drug_target	
ORM1	drug_target	
PLAT	drug_target	
Hyoscyamine	drug	
Ibuprofen	drug	
Gastric ulcer	phenotype	
PTGS2	drug_target	
DRD3	drug_target	
Doxylamine	drug	
FMO1	drug_target	
ALB	drug_target	
CHRM2	drug_target	
HTR1D	drug_target	
ACHE	drug_target	
HTR2B	drug_target	
Caffeine	drug	
HTR7	drug_target	
KIT	drug_target	
CYP1A2	drug_target	
NFATC1	drug_target	
ADRB2	drug_target	
PIK3CB	drug_target	
TNF	drug_target	
UGT2B7	drug_target	
Thalidomide	drug	
ADRA1D	drug_target	
ADRA2B	drug_target	
SLCO1A2	drug_target	
BCL2	drug_target	
SCN5A	drug_target	
CYP2C19	drug_target	
THBD	drug_target	
SLC22A5	drug_target	
CYP2A6	drug_target	
GRM5	drug_target	
DRD5	drug_target	
Lidocaine	drug	
