LYN	drug_target	
SLCO2B1	drug_target	
GLUL	drug_target	
Nintedanib	drug	
HTR2A	drug_target	
MAPK11	drug_target	
Tetracycline	drug	
CHRM5	drug_target	
CA2	drug_target	
MPO	drug_target	
UGT1A8	drug_target	
MT-ND1	drug_target	
Nilotinib	drug	
ADRA2C	drug_target	
HPSE	drug_target	
ADORA1	drug_target	
Flurbiprofen	drug	
HTR2C	drug_target	
LY96	drug_target	
RET	drug_target	
CANX	drug_target	
Dabigatran Etexilate	drug	
DBH	drug_target	
Diflunisal	drug	
KDR	drug_target	
FLT3	drug_target	
CYP2C18	drug_target	
Certolizumab Pegol	drug	
SLC22A4	drug_target	
HTR1E	drug_target	
GLRA1	drug_target	
Oxaprozin	drug	
PON1	drug_target	
AR	drug_target	
SLCO1C1	drug_target	
Diazoxide	drug	
ABCC4	drug_target	
KCNQ2	drug_target	
Gastrointestinal hemorrhage	phenotype	
TSPO	drug_target	
KCNH2	drug_target	
SLC16A1	drug_target	
Prasugrel	drug	
KLK1	drug_target	
SLC47A1	drug_target	
NFKB1	drug_target	
Clonazepam	drug	
NTRK1	drug_target	
IL1B	drug_target	
Salicylic Acid	drug	
PTGS1	drug_target	
Carvedilol	drug	
RXRA	drug_target	
EGFR	drug_target	
ORM1	drug_target	
FCGR2A	drug_target	
Glucosamine	drug	
KCNA1	drug_target	
DRD3	drug_target	
Vancomycin	drug	
SRC	drug_target	
CHRM2	drug_target	
TTR	drug_target	
CYP1A2	drug_target	
NQO2	drug_target	
C1R	drug_target	
VLDLR	drug_target	
FGFR1	drug_target	
Desflurane	drug	
UGT2B7	drug_target	
Pazopanib	drug	
Edoxaban	drug	
Bismuth Subsalicylate	drug	
Enoxaparin	drug	
FLT1	drug_target	
GGH	drug_target	
DRD5	drug_target	
Lidocaine	drug	
HSD11B1	drug_target	
Regorafenib	drug	
CHRM3	drug_target	
TF	drug_target	
CYP3A5	drug_target	
Subcutaneous hemorrhage	phenotype	
SCN10A	drug_target	
Cabozantinib	drug	
CRBN	drug_target	
Internal hemorrhage	phenotype	
Rivaroxaban	drug	
ADRA1A	drug_target	
SLC22A2	drug_target	
LTA	drug_target	
PTGER1	drug_target	
Oxymetholone	drug	
Cephalexin	drug	
UGT1A9	drug_target	
ADRA2A	drug_target	
GRIA1	drug_target	
UGT2B4	drug_target	
ABL2	drug_target	
PRDX5	drug_target	
Aripiprazole	drug	
Cefazolin	drug	
NFKB2	drug_target	
KCNQ3	drug_target	
MTHFR	drug_target	
Auranofin	drug	
GLTP	drug_target	
Ipilimumab	drug	
ABCG2	drug_target	
DHFR	drug_target	
CYP2E1	drug_target	
FCGR3A	drug_target	
TDO2	drug_target	
EPHA2	drug_target	
RXRB	drug_target	
Peptic Ulcer Hemorrhage	phenotype	
CYP1A1	drug_target	
GJA1	drug_target	
CYP1B1	drug_target	
Quetiapine	drug	
BRAF	drug_target	
ATP5D	drug_target	
RARB	drug_target	
DRD1	drug_target	
Nabumetone	drug	
Meclofenamic Acid	drug	
FGFR2	drug_target	
CXCR1	drug_target	
PTGIR	drug_target	
Etanercept	drug	
CHRM1	drug_target	
DRD4	drug_target	
Meloxicam	drug	
Ponatinib	drug	
SLC22A11	drug_target	
HRH1	drug_target	
CES1	drug_target	
Eptifibatide	drug	
TFPI	drug_target	
Tenecteplase	drug	
Leuprolide	drug	
Risperidone	drug	
Ketoprofen	drug	
GM2A	drug_target	
SLC12A3	drug_target	
NPPB	drug_target	
KCNN4	drug_target	
ALB	drug_target	
SLC46A1	drug_target	
PRSS1	drug_target	
Acitretin	drug	
HTR7	drug_target	
FGA	drug_target	
KIT	drug_target	
Abciximab	drug	
SH2B3	drug_target	
MMP9	drug_target	
Intracranial hemorrhage	phenotype	
RBP1	drug_target	
BCR	drug_target	
Aprotinin	drug	
ADRA1D	drug_target	
ABCC2	drug_target	
SLCO1A2	drug_target	
SCN5A	drug_target	
LRP1	drug_target	
SLC22A5	drug_target	
Epinephrine	drug	
VEGFA	drug_target	
Cefotetan	drug	
HRH2	drug_target	
ADRB3	drug_target	
STAT5B	drug_target	
ADORA2A	drug_target	
HTR3A	drug_target	
ATIC	drug_target	
Hyaluronidase	drug	
PLAUR	drug_target	
SELE	drug_target	
PDGFRA	drug_target	
HTR1B	drug_target	
ABCB1	drug_target	
CA1	drug_target	
Reteplase	drug	
PAH	drug_target	
ITK	drug_target	
FCGR3B	drug_target	
Subarachnoid hemorrhage	phenotype	
ABCC3	drug_target	
Cefotaxime	drug	
CTLA4	drug_target	
AOX1	drug_target	
SERPINB2	drug_target	
Naproxen	drug	
MAOA	drug_target	
Methyltestosterone	drug	
HTR5A	drug_target	
KCNJ11	drug_target	
PADI4	drug_target	
Bivalirudin	drug	
ABL1	drug_target	
SLC22A6	drug_target	
Sevoflurane	drug	
GP9	drug_target	
ANXA2	drug_target	
Tolmetin	drug	
FGF1	drug_target	
CYP3A4	drug_target	
ADRA1B	drug_target	
HNF4A	drug_target	
XDH	drug_target	
PLA2G2A	drug_target	
CLEC3B	drug_target	
Heparin	drug	
SERPINC1	drug_target	
Olanzapine	drug	
Iloprost	drug	
Ampicillin	drug	
GABRA1	drug_target	
Brain Hemorrhage, Traumatic	phenotype	
Methotrexate	drug	
Mefenamic Acid	drug	
ABCA5	drug_target	
IL1RN	drug_target	
RALBP1	drug_target	
C1S	drug_target	
Dalteparin	drug	
ABCC11	drug_target	
DRD2	drug_target	
Pentoxifylline	drug	
FOLR1	drug_target	
HTR1A	drug_target	
HRH4	drug_target	
CYP2J2	drug_target	
ABCC10	drug_target	
SLC22A8	drug_target	
PLAT	drug_target	
SLCO1B1	drug_target	
UGT2B15	drug_target	
Tirofiban	drug	
Cerebral Hemorrhage	phenotype	
IFNG	drug_target	
FMO1	drug_target	
TEK	drug_target	
Nafarelin	drug	
PDE5A	drug_target	
DDR2	drug_target	
HTR2B	drug_target	
TLR4	drug_target	
RAF1	drug_target	
PDE4C	drug_target	
NDUFC2	drug_target	
VCAM1	drug_target	
LCK	drug_target	
ADRB2	drug_target	
PLG	drug_target	
PDE4D	drug_target	
Vandetanib	drug	
SERPINE1	drug_target	
ALOX5	drug_target	
CYP2C19	drug_target	
VTN	drug_target	
FPGS	drug_target	
CYP2A6	drug_target	
GRM5	drug_target	
Ceftriaxone	drug	
Fondaparinux Sodium	drug	
UGT1A1	drug_target	
Quinine	drug	
PTK6	drug_target	
FKBP1A	drug_target	
Sorafenib	drug	
KRT8	drug_target	
SRD5A1	drug_target	
Velaglucerase Alfa	drug	
MET	drug_target	
PDE4A	drug_target	
Ramucirumab	drug	
ITGA2B	drug_target	
Tacrolimus	drug	
RXRG	drug_target	
Goserelin	drug	
F2	drug_target	
FCGR1A	drug_target	
SELP	drug_target	
PDE4B	drug_target	
Tiopronin	drug	
RARA	drug_target	
LHCGR	drug_target	
FLT4	drug_target	
UGT1A3	drug_target	
TNFRSF1B	drug_target	
NAT2	drug_target	
AKR1C1	drug_target	
PLA2G2D	drug_target	
CYP26A1	drug_target	
FCGR2B	drug_target	
GNRHR	drug_target	
Olsalazine	drug	
CALR	drug_target	
ATP2C1	drug_target	
Acamprosate	drug	
ABCB11	drug_target	
NT5E	drug_target	
SHBG	drug_target	
HTR6	drug_target	
ABCC1	drug_target	
FMO3	drug_target	
ATP1A1	drug_target	
CYP2C9	drug_target	
F10	drug_target	
CYP2C8	drug_target	
LTF	drug_target	
C1QC	drug_target	
Bromfenac	drug	
SLC15A2	drug_target	
TPO	drug_target	
CYP2D6	drug_target	
SLCO3A1	drug_target	
CHRM4	drug_target	
NR3C1	drug_target	
CYP2B6	drug_target	
Alteplase	drug	
PGD	drug_target	
SLCO1B3	drug_target	
SLC19A1	drug_target	
Piroxicam	drug	
MS4A1	drug_target	
FRK	drug_target	
Fosphenytoin	drug	
Triptorelin	drug	
Rilonacept	drug	
RARG	drug_target	
Infliximab	drug	
IKBKB	drug_target	
TYMS	drug_target	
ADRB1	drug_target	
PDGFRB	drug_target	
SLC22A1	drug_target	
C1QA	drug_target	
IL1A	drug_target	
FCGR2C	drug_target	
Prednisone	drug	
PTGS2	drug_target	
Obinutuzumab	drug	
HIF1A	drug_target	
YES1	drug_target	
HTR1D	drug_target	
FGFR3	drug_target	
CYP19A1	drug_target	
C8G	drug_target	
TGFB1	drug_target	
ITGB3	drug_target	
PRNP	drug_target	
ADH5	drug_target	
P2RY12	drug_target	
Propylthiouracil	drug	
C1QB	drug_target	
Lauric Acid	drug	
GBA	drug_target	
TNF	drug_target	
FYN	drug_target	
TPMT	drug_target	
Thalidomide	drug	
ADRA2B	drug_target	
Dasatinib	drug	
FGFR4	drug_target	
KCNMA1	drug_target	
Phenylephrine	drug	
Fenoprofen	drug	
