UGT1A1	drug_target	
SLCO2B1	drug_target	
JAK3	drug_target	
HRH2	drug_target	
Zidovudine	drug	
CHRM3	drug_target	
FKBP1A	drug_target	
ATIC	drug_target	
SLC22A3	drug_target	
HTR3A	drug_target	
CYP3A5	drug_target	
CYP3A43	drug_target	
SCN10A	drug_target	
HTR1B	drug_target	
HTR2A	drug_target	
GLRA3	drug_target	
ADRA1A	drug_target	
GARS	drug_target	
ABCB1	drug_target	
CHRM5	drug_target	
SLC22A2	drug_target	
Fluoxetine	drug	
Valsartan	drug	
UGT1A8	drug_target	
Tacrolimus	drug	
UGT1A9	drug_target	
ADRA2A	drug_target	
ABCC3	drug_target	
ADRA2C	drug_target	
AOX1	drug_target	
AGTR1	drug_target	
FABP2	drug_target	
ADORA1	drug_target	
HTR2C	drug_target	
Propafenone	drug	
ALAS1	drug_target	
HTR5A	drug_target	
MAOA	drug_target	
Aripiprazole	drug	
RARA	drug_target	
Betaxolol	drug	
Hyperlipidemia, familial combined	phenotype	
Ziprasidone	drug	
GCSH	drug_target	
SLC22A6	drug_target	
OPRK1	drug_target	
GLRA2	drug_target	
Estradiol	drug	
GRIN1	drug_target	
MTHFR	drug_target	
ABCC5	drug_target	
ABCG2	drug_target	
DHFR	drug_target	
CACNA1B	drug_target	
SHMT1	drug_target	
SHBG	drug_target	
HTR6	drug_target	
CYP2E1	drug_target	
CYP2C18	drug_target	
Memantine	drug	
ABCC1	drug_target	
GABRB3	drug_target	
SLC10A1	drug_target	
SLC22A4	drug_target	
BAAT	drug_target	
HTR1E	drug_target	
GLRA1	drug_target	
FMO3	drug_target	
GRIN3B	drug_target	
SLCO4A1	drug_target	
SLC6A5	drug_target	
Warfarin	drug	
CYP3A4	drug_target	
ADRA1B	drug_target	
Sotalol	drug	
CYP2C9	drug_target	
SLCO1C1	drug_target	
AR	drug_target	
SLC6A9	drug_target	
CYP1A1	drug_target	
ESR1	drug_target	
CYP2C8	drug_target	
Arformoterol	drug	
ESR2	drug_target	
ABCC4	drug_target	
JAK2	drug_target	
VKORC1	drug_target	
Hyperlipidemia, combined, 1	phenotype	
Glycine	drug	
GNMT	drug_target	
SCN4A	drug_target	
Olanzapine	drug	
Propofol	drug	
AGXT2	drug_target	
CYP1B1	drug_target	
Quetiapine	drug	
Tofacitinib	drug	
CYP2D6	drug_target	
SLCO3A1	drug_target	
CHRM4	drug_target	
DRD1	drug_target	
Methotrexate	drug	
CYP2B6	drug_target	
KCNH2	drug_target	
SLC16A1	drug_target	
Prasugrel	drug	
PGD	drug_target	
ABCA5	drug_target	
AGXT	drug_target	
SLCO1B3	drug_target	
CHRM1	drug_target	
SLC19A1	drug_target	
DRD4	drug_target	
ABCC11	drug_target	
DRD2	drug_target	
Isotretinoin	drug	
Menthol	drug	
Testosterone	drug	
SLC22A11	drug_target	
HRH1	drug_target	
FOLR1	drug_target	
CYP11A1	drug_target	
Bisoprolol	drug	
HTR1A	drug_target	
Pramipexole	drug	
TYMS	drug_target	
UGT1A6	drug_target	
ADRB1	drug_target	
GATM	drug_target	
GABRB2	drug_target	
SLC6A4	drug_target	
HRH4	drug_target	
ABCC10	drug_target	
GLDC	drug_target	
SLC22A1	drug_target	
EGFR	drug_target	
JAK1	drug_target	
Gabapentin	drug	
SLC22A8	drug_target	
ORM1	drug_target	
SLCO1B1	drug_target	
CACNA2D1	drug_target	
DRD3	drug_target	
GRIN2B	drug_target	
GRIN2C	drug_target	
SLC32A1	drug_target	
GLRB	drug_target	
GCAT	drug_target	
FAAH	drug_target	
TRPM8	drug_target	
TK1	drug_target	
ALB	drug_target	
SHMT2	drug_target	
PIPOX	drug_target	
SLC46A1	drug_target	
CHRM2	drug_target	
HTR1D	drug_target	
HTR2B	drug_target	
SCN2A	drug_target	
GSS	drug_target	
CYP19A1	drug_target	
SLC29A2	drug_target	
HTR7	drug_target	
CYP1A2	drug_target	
ADRB2	drug_target	
P2RY12	drug_target	
TERT	drug_target	
SLC16A10	drug_target	
SLC28A1	drug_target	
CYP2A13	drug_target	
NR1I2	drug_target	
UGT2B7	drug_target	
GRIN2A	drug_target	
Saquinavir	drug	
ADRA1D	drug_target	
ADRA2B	drug_target	
ABCC2	drug_target	
ALAS2	drug_target	
BCAT1	drug_target	
SLCO1A2	drug_target	
SCN5A	drug_target	
CACNA2D2	drug_target	
GRIN3A	drug_target	
CYP2C19	drug_target	
GLYAT	drug_target	
FPGS	drug_target	
CYP2A6	drug_target	
SLC22A5	drug_target	
GGH	drug_target	
DRD5	drug_target	
GPR18	drug_target	
Lidocaine	drug	
