Citalopram	drug	
IL3RA	drug_target	
IL2	drug_target	
LYN	drug_target	
SLCO2B1	drug_target	
Rocuronium	drug	
SI	drug_target	
IL6R	drug_target	
Ketorolac	drug	
PPARG	drug_target	
Indomethacin	drug	
Nintedanib	drug	
Escitalopram	drug	
SLC7A8	drug_target	
HTR2A	drug_target	
Timolol	drug	
Pulmonary hypertension, neonatal, susceptibility to	phenotype	
Bromocriptine	drug	
MAPK11	drug_target	
MAP2K1	drug_target	
CHRNA2	drug_target	
Trimipramine	drug	
ANXA1	drug_target	
Metoclopramide	drug	
CHRM5	drug_target	
CSF1R	drug_target	
MPO	drug_target	
ABCC6	drug_target	
UGT1A8	drug_target	
Sargramostim	drug	
CYP17A1	drug_target	
QPRT	drug_target	
CSF2RA	drug_target	
ADRA2C	drug_target	
HPSE	drug_target	
ATP7A	drug_target	
ADORA1	drug_target	
HTR2C	drug_target	
ALAS1	drug_target	
CHRNA3	drug_target	
Darbepoetin Alfa	drug	
Phentolamine	drug	
RET	drug_target	
CANX	drug_target	
Ziprasidone	drug	
MAP3K2	drug_target	
DBH	drug_target	
Scopolamine	drug	
Zolmitriptan	drug	
Insulin Glargine	drug	
SLC6A2	drug_target	
Ocular Hypertension	phenotype	
KDR	drug_target	
CACNA1B	drug_target	
FLT3	drug_target	
SHMT1	drug_target	
Cysteamine	drug	
NQO1	drug_target	
Ropinirole	drug	
CYP2C18	drug_target	
CHRNA7	drug_target	
Ergotamine	drug	
HBA2	drug_target	
SLC22A4	drug_target	
HTR1E	drug_target	
GLRA1	drug_target	
SLC6A5	drug_target	
Desipramine	drug	
Nefazodone	drug	
Asenapine	drug	
Primary pulmonary hypertension	phenotype	
Pertuzumab	drug	
AR	drug_target	
SLCO1C1	drug_target	
Oxycodone	drug	
AVPR2	drug_target	
ABCC4	drug_target	
PPARA	drug_target	
Dronabinol	drug	
GNMT	drug_target	
AGXT2	drug_target	
Salsalate	drug	
UGT1A4	drug_target	
ATP7B	drug_target	
KCNQ2	drug_target	
Cyclobenzaprine	drug	
OPRM1	drug_target	
Renal hypertension	phenotype	
Ephedrine	drug	
KCNH2	drug_target	
SLC16A1	drug_target	
Prasugrel	drug	
Febuxostat	drug	
Atropine	drug	
CYP4A11	drug_target	
Pasireotide	drug	
Naltrexone	drug	
Sunitinib	drug	
Naratriptan	drug	
NTRK1	drug_target	
Oxymorphone	drug	
PTGS1	drug_target	
Degarelix	drug	
MT1A	drug_target	
SLC22A12	drug_target	
SLC2A1	drug_target	
RXRA	drug_target	
EGFR	drug_target	
ORM1	drug_target	
SLC31A2	drug_target	
Ibuprofen	drug	
Formoterol	drug	
SSTR2	drug_target	
Tesamorelin	drug	
HCK	drug_target	
KCNA1	drug_target	
Azathioprine	drug	
DRD3	drug_target	
SST	drug_target	
SLC32A1	drug_target	
GLRB	drug_target	
Hyperuricemia, pulmonary hypertension, renal failure, and alkalosis	phenotype	
Sumatriptan	drug	
TK1	drug_target	
Diphenoxylate	drug	
SRC	drug_target	
CHRM2	drug_target	
INSR	drug_target	
Dexamethasone	drug	
KCNH7	drug_target	
Dextromethorphan	drug	
CYP1A2	drug_target	
Fentanyl	drug	
CXCL12	drug_target	
Ranitidine	drug	
Tocilizumab	drug	
Promethazine	drug	
Remifentanil	drug	
Nabilone	drug	
Carboplatin	drug	
Etonogestrel	drug	
FGFR1	drug_target	
UGT2B7	drug_target	
BCHE	drug_target	
Loxapine	drug	
Rotigotine	drug	
GRIN3A	drug_target	
GLYAT	drug_target	
FLT1	drug_target	
DRD5	drug_target	
Codeine	drug	
Morphine	drug	
Tramadol	drug	
Regorafenib	drug	
CHRM3	drug_target	
ERBB2	drug_target	
CARTPT	drug_target	
Triamcinolone	drug	
SLC22A3	drug_target	
ADAMTS4	drug_target	
CYP3A5	drug_target	
ABCC8	drug_target	
Regadenoson	drug	
KCND3	drug_target	
Cabozantinib	drug	
Haloperidol	drug	
ADORA2B	drug_target	
Donepezil	drug	
ADRA1A	drug_target	
GARS	drug_target	
NPY2R	drug_target	
SLC22A2	drug_target	
PTGER1	drug_target	
Insulin Detemir	drug	
UGT1A9	drug_target	
ADRA2A	drug_target	
UGT2B4	drug_target	
ABL2	drug_target	
PTH1R	drug_target	
Carbinoxamine	drug	
Ondansetron	drug	
Hydrocodone	drug	
Aripiprazole	drug	
MAP2K2	drug_target	
Pimozide	drug	
HCAR3	drug_target	
KCNQ3	drug_target	
GLRA2	drug_target	
Estradiol	drug	
Droxidopa	drug	
Buspirone	drug	
MTHFR	drug_target	
ABCC5	drug_target	
Losartan	drug	
ABCG2	drug_target	
Mefloquine	drug	
Lurasidone	drug	
Norgestimate	drug	
CYP2E1	drug_target	
TDO2	drug_target	
EPHA2	drug_target	
NR3C2	drug_target	
RXRB	drug_target	
SLC16A3	drug_target	
GRIN3B	drug_target	
Niacin	drug	
SLCO4A1	drug_target	
Sotalol	drug	
Metoprolol	drug	
SLC6A9	drug_target	
CHRNB2	drug_target	
HTR1F	drug_target	
CYP1A1	drug_target	
ESR2	drug_target	
Droperidol	drug	
genetic hypertension	phenotype	
JAK2	drug_target	
Glycine	drug	
CALY	drug_target	
CYP1B1	drug_target	
Quetiapine	drug	
Lanreotide	drug	
Tofacitinib	drug	
Clozapine	drug	
Oxaliplatin	drug	
BRAF	drug_target	
RARB	drug_target	
Dextroamphetamine	drug	
DRD1	drug_target	
Nabumetone	drug	
Meclofenamic Acid	drug	
FGFR2	drug_target	
CXCR1	drug_target	
Solifenacin	drug	
PTGIR	drug_target	
KCNH6	drug_target	
MT2A	drug_target	
Travoprost	drug	
CHRM1	drug_target	
Bazedoxifene	drug	
DRD4	drug_target	
NNMT	drug_target	
Menthol	drug	
Cinacalcet	drug	
HPRT1	drug_target	
Oxybutynin	drug	
Ponatinib	drug	
SSTR5	drug_target	
SLC22A11	drug_target	
HRH1	drug_target	
NTRK2	drug_target	
CYP11A1	drug_target	
Ketamine	drug	
Repaglinide	drug	
CES1	drug_target	
SERPINA6	drug_target	
TFPI	drug_target	
GLDC	drug_target	
Dicyclomine	drug	
Tenecteplase	drug	
Isometheptene	drug	
Drospirenone	drug	
Hyoscyamine	drug	
TRHR	drug_target	
Leuprolide	drug	
CACNA2D1	drug_target	
Octreotide	drug	
Risperidone	drug	
Ketoprofen	drug	
DDC	drug_target	
PTGDR2	drug_target	
CNR2	drug_target	
Naphazoline	drug	
Perphenazine	drug	
GRIN2C	drug_target	
Essential hypertension	phenotype	
SIGMAR1	drug_target	
Hypertension	phenotype	
ALB	drug_target	
SHMT2	drug_target	
Conivaptan	drug	
Tiotropium	drug	
Oxcarbazepine	drug	
Acitretin	drug	
HTR7	drug_target	
KIT	drug_target	
ITGA4	drug_target	
FGA	drug_target	
SSTR3	drug_target	
SLC16A10	drug_target	
CYP2A13	drug_target	
RBP1	drug_target	
Indacaterol	drug	
CALM3	drug_target	
NR1I2	drug_target	
BCR	drug_target	
Riboflavin	drug	
ADRA1D	drug_target	
ABCC2	drug_target	
CNR1	drug_target	
SCN5A	drug_target	
SLCO1A2	drug_target	
CACNA2D2	drug_target	
LRP1	drug_target	
SLC22A5	drug_target	
Epinephrine	drug	
CDK2	drug_target	
Ipratropium Bromide	drug	
VEGFA	drug_target	
PGR	drug_target	
JAK3	drug_target	
Amoxapine	drug	
HRH2	drug_target	
ADRB3	drug_target	
STAT5B	drug_target	
CREB1	drug_target	
Adenosine	drug	
HTR3A	drug_target	
ADORA2A	drug_target	
Hyaluronidase	drug	
HTR4	drug_target	
GLO1	drug_target	
PLAUR	drug_target	
Amitriptyline	drug	
HTR1B	drug_target	
PDGFRA	drug_target	
Eculizumab	drug	
HCAR2	drug_target	
ABCB1	drug_target	
Amantadine	drug	
PAH	drug_target	
Rizatriptan	drug	
ADK	drug_target	
NOS2	drug_target	
SLC5A8	drug_target	
ABCC3	drug_target	
Ticagrelor	drug	
Pentazocine	drug	
Cabergoline	drug	
Modafinil	drug	
AGTR1	drug_target	
Methamphetamine	drug	
SERPINB2	drug_target	
AOX1	drug_target	
Paliperidone	drug	
MAOA	drug_target	
HTR5A	drug_target	
Portal hypertension, noncirrhotic	phenotype	
Butorphanol	drug	
Diphenhydramine	drug	
Bivalirudin	drug	
ABL1	drug_target	
Brompheniramine	drug	
SLC22A6	drug_target	
Vigabatrin	drug	
Pulmonary arterial hypertension	phenotype	
Levonorgestrel	drug	
Mirtazapine	drug	
HRH3	drug_target	
GSTT1	drug_target	
Triprolidine	drug	
Darifenacin	drug	
ADA	drug_target	
Dihydroergotamine	drug	
ANXA2	drug_target	
Naloxone	drug	
GABBR1	drug_target	
SLC10A1	drug_target	
Tolmetin	drug	
Paroxetine	drug	
CYP3A4	drug_target	
ADRA1B	drug_target	
AVPR1A	drug_target	
XDH	drug_target	
PLA2G2A	drug_target	
Arformoterol	drug	
PTGR2	drug_target	
CLEC3B	drug_target	
Renovascular hypertension	phenotype	
DDR1	drug_target	
Imipramine	drug	
SERPINC1	drug_target	
Olanzapine	drug	
Iloprost	drug	
GABRA1	drug_target	
PGRMC1	drug_target	
Azelastine	drug	
C5	drug_target	
Mirabegron	drug	
Clemastine	drug	
RALBP1	drug_target	
Pregnancy associated hypertension	phenotype	
Dalteparin	drug	
ABCC11	drug_target	
DRD2	drug_target	
MAOB	drug_target	
Cyclopentolate	drug	
HTR1A	drug_target	
Pramipexole	drug	
Lisdexamfetamine	drug	
HRH4	drug_target	
SLC6A4	drug_target	
ABCC10	drug_target	
Propranolol	drug	
CFTR	drug_target	
JAK1	drug_target	
SLC22A8	drug_target	
PLAT	drug_target	
CAMK2G	drug_target	
CBR1	drug_target	
HNMT	drug_target	
SLCO1B1	drug_target	
UGT2B15	drug_target	
SSTR1	drug_target	
Clonidine	drug	
Pilocarpine	drug	
GRIN2B	drug_target	
FMO1	drug_target	
TRPM8	drug_target	
TEK	drug_target	
DDR2	drug_target	
PRG2	drug_target	
HTR2B	drug_target	
TLR4	drug_target	
RAF1	drug_target	
BLVRB	drug_target	
GSS	drug_target	
PDE4C	drug_target	
NFATC1	drug_target	
GSTA2	drug_target	
OPRD1	drug_target	
LCK	drug_target	
UGT1A10	drug_target	
Propantheline	drug	
ADRB2	drug_target	
Histamine	drug	
Frovatriptan	drug	
PLG	drug_target	
SLC28A1	drug_target	
PDE4D	drug_target	
Vandetanib	drug	
TAAR1	drug_target	
SERPINE1	drug_target	
Nepafenac	drug	
ALOX5	drug_target	
BCAT1	drug_target	
ALAS2	drug_target	
Terbutaline	drug	
BCL2	drug_target	
Trihexyphenidyl	drug	
CYP2C19	drug_target	
THBD	drug_target	
CYP2A6	drug_target	
GRM5	drug_target	
GATM	drug_target	
Terazosin	drug	
GPR18	drug_target	
UGT1A1	drug_target	
PTK6	drug_target	
Zidovudine	drug	
IGF1R	drug_target	
Lenvatinib	drug	
Eletriptan	drug	
Succinylcholine	drug	
SMPD1	drug_target	
Tizanidine	drug	
Nortriptyline	drug	
CYP3A43	drug_target	
GLRA3	drug_target	
Sorafenib	drug	
Allopurinol	drug	
KRT8	drug_target	
SRD5A1	drug_target	
MET	drug_target	
PDE4A	drug_target	
EPOR	drug_target	
Ramucirumab	drug	
Amphetamine	drug	
Midodrine	drug	
Pseudoephedrine	drug	
Tinzaparin	drug	
RXRG	drug_target	
Cetirizine	drug	
Goserelin	drug	
COMT	drug_target	
F2	drug_target	
SLC31A1	drug_target	
Desogestrel	drug	
FABP2	drug_target	
GSTM1	drug_target	
Progesterone	drug	
POU5F1	drug_target	
SELP	drug_target	
GSTP1	drug_target	
PDE4B	drug_target	
RARA	drug_target	
LHCGR	drug_target	
NISCH	drug_target	
FLT4	drug_target	
UGT1A3	drug_target	
GCSH	drug_target	
Teriparatide	drug	
OPRK1	drug_target	
Imatinib	drug	
GRIN1	drug_target	
CYP26A1	drug_target	
GNRHR	drug_target	
CALR	drug_target	
NR0B1	drug_target	
Acamprosate	drug	
ABCB11	drug_target	
SHBG	drug_target	
HTR6	drug_target	
Cevimeline	drug	
Memantine	drug	
ABCC1	drug_target	
Metipranolol	drug	
CHRNA4	drug_target	
BAAT	drug_target	
FMO3	drug_target	
Pergolide	drug	
CYP2C9	drug_target	
Almotriptan	drug	
ESR1	drug_target	
Bosutinib	drug	
CYP2C8	drug_target	
TACR1	drug_target	
GSTA1	drug_target	
GHRHR	drug_target	
RFK	drug_target	
ABCA3	drug_target	
Levodopa	drug	
CYP2D6	drug_target	
SLCO3A1	drug_target	
CHRM4	drug_target	
NR3C1	drug_target	
CYP2B6	drug_target	
Salmeterol	drug	
AGXT	drug_target	
Hydromorphone	drug	
Etomidate	drug	
CYP11B2	drug_target	
SLCO1B3	drug_target	
Piroxicam	drug	
KCND2	drug_target	
FRK	drug_target	
Trazodone	drug	
SLC18A2	drug_target	
Testosterone	drug	
Oxymetazoline	drug	
CASR	drug_target	
Triptorelin	drug	
Sufentanil	drug	
RARG	drug_target	
ADRB1	drug_target	
Fluphenazine	drug	
Apraclonidine	drug	
PDGFRB	drug_target	
SLC22A1	drug_target	
SLC6A3	drug_target	
SDC2	drug_target	
Gabapentin	drug	
Famotidine	drug	
Doxepin	drug	
PTGS2	drug_target	
Cyproheptadine	drug	
CHRNB4	drug_target	
GCAT	drug_target	
SLC28A3	drug_target	
PIPOX	drug_target	
YES1	drug_target	
SLC7A5	drug_target	
HTR1D	drug_target	
ACHE	drug_target	
FGFR3	drug_target	
CYP19A1	drug_target	
SLC29A2	drug_target	
Maprotiline	drug	
TGFB1	drug_target	
Nalbuphine	drug	
Protirelin	drug	
P2RY12	drug_target	
TERT	drug_target	
Mometasone	drug	
TNF	drug_target	
FYN	drug_target	
TPMT	drug_target	
GRIN2A	drug_target	
ADRA2B	drug_target	
Dasatinib	drug	
Buprenorphine	drug	
PTGFR	drug_target	
FGFR4	drug_target	
CSF2RB	drug_target	
SOD1	drug_target	
Phenylephrine	drug	
Dopamine	drug	
Fenoprofen	drug	
