Citalopram	drug	
IL2	drug_target	
SLCO2B1	drug_target	
Ketorolac	drug	
CTSD	drug_target	
PPARG	drug_target	
Indomethacin	drug	
Escitalopram	drug	
SLC7A8	drug_target	
HTR2A	drug_target	
SLC29A1	drug_target	
Bromocriptine	drug	
CCR5	drug_target	
Trimipramine	drug	
ANXA1	drug_target	
Metoclopramide	drug	
CHRM5	drug_target	
Tranexamic Acid	drug	
MPO	drug_target	
ABCC6	drug_target	
UGT1A8	drug_target	
Celecoxib	drug	
CYP17A1	drug_target	
MT-ND1	drug_target	
ADRA2C	drug_target	
Sapropterin	drug	
Trandolapril	drug	
HPSE	drug_target	
ADORA1	drug_target	
Flurbiprofen	drug	
HTR2C	drug_target	
Nicardipine	drug	
RB1	drug_target	
Pindolol	drug	
Phentolamine	drug	
Quinapril	drug	
CANX	drug_target	
SLC16A2	drug_target	
THRA	drug_target	
Zolmitriptan	drug	
UPP2	drug_target	
Liothyronine	drug	
Diflunisal	drug	
SLC6A2	drug_target	
CACNA1B	drug_target	
Ropinirole	drug	
CYP2C18	drug_target	
Certolizumab Pegol	drug	
JUN	drug_target	
SLC22A4	drug_target	
HTR1E	drug_target	
GLRA1	drug_target	
Desipramine	drug	
AR	drug_target	
SLCO1C1	drug_target	
ABCC4	drug_target	
PPARA	drug_target	
Salsalate	drug	
UGT1A4	drug_target	
KCNQ2	drug_target	
Cyclobenzaprine	drug	
DPYD	drug_target	
OPRM1	drug_target	
Hydroxyzine	drug	
KCNH2	drug_target	
SLC16A1	drug_target	
KLK1	drug_target	
PDE1A	drug_target	
Atropine	drug	
CYP4A11	drug_target	
Pasireotide	drug	
Naratriptan	drug	
NTRK1	drug_target	
Salicylic Acid	drug	
CPE	drug_target	
PTGS1	drug_target	
PCSK2	drug_target	
SLC22A12	drug_target	
RXRA	drug_target	
SERPINA7	drug_target	
EGFR	drug_target	
Doxazosin	drug	
ORM1	drug_target	
Fosinopril	drug	
Ibuprofen	drug	
FCGR2A	drug_target	
SSTR2	drug_target	
Fluorouracil	drug	
KCNA1	drug_target	
DRD3	drug_target	
FAAH	drug_target	
Sumatriptan	drug	
TK1	drug_target	
SRC	drug_target	
CHRM2	drug_target	
INSR	drug_target	
UPP1	drug_target	
TTR	drug_target	
Dexamethasone	drug	
KCNH7	drug_target	
CYP1A2	drug_target	
Fentanyl	drug	
CXCL12	drug_target	
C1R	drug_target	
Desflurane	drug	
UGT2B7	drug_target	
BCHE	drug_target	
GRIN3A	drug_target	
DRD5	drug_target	
Lidocaine	drug	
Etodolac	drug	
HSD11B1	drug_target	
Tramadol	drug	
CHRM3	drug_target	
CARTPT	drug_target	
SLC22A3	drug_target	
ADAMTS4	drug_target	
CYP3A5	drug_target	
ABCC8	drug_target	
ACE2	drug_target	
TYMP	drug_target	
KCND3	drug_target	
SCN10A	drug_target	
ADORA2B	drug_target	
Donepezil	drug	
ADRA1A	drug_target	
SLC22A2	drug_target	
CACNA1C	drug_target	
Valsartan	drug	
LRP2	drug_target	
ACE	drug_target	
Adalimumab	drug	
UGT1A9	drug_target	
ADRA2A	drug_target	
GRIA1	drug_target	
UGT2B4	drug_target	
ABL2	drug_target	
PDE1B	drug_target	
Aripiprazole	drug	
HDAC1	drug_target	
KCNQ3	drug_target	
Estradiol	drug	
AKR1B1	drug_target	
UMPS	drug_target	
MTHFR	drug_target	
ABCC5	drug_target	
Losartan	drug	
Levothyroxine	drug	
ABCG2	drug_target	
Lurasidone	drug	
CYP2E1	drug_target	
FCGR3A	drug_target	
TDO2	drug_target	
EPHA2	drug_target	
NR3C2	drug_target	
SLCO4A1	drug_target	
Sotalol	drug	
HTR1F	drug_target	
CYP1A1	drug_target	
ESR2	drug_target	
Apomorphine	drug	
Propofol	drug	
CALY	drug_target	
CYP1B1	drug_target	
ATP5D	drug_target	
Clozapine	drug	
Sulindac	drug	
Dextroamphetamine	drug	
DRD1	drug_target	
CCL2	drug_target	
CXCR1	drug_target	
ASIC1	drug_target	
KCNH6	drug_target	
CHRM1	drug_target	
Clomipramine	drug	
DRD4	drug_target	
CACNA1D	drug_target	
Menthol	drug	
Disopyramide	drug	
SSTR5	drug_target	
SLC22A11	drug_target	
SYTL4	drug_target	
HRH1	drug_target	
NTRK2	drug_target	
CYP11A1	drug_target	
Repaglinide	drug	
Maraviroc	drug	
CPT1A	drug_target	
CES1	drug_target	
Tenecteplase	drug	
Leuprolide	drug	
CACNA2D1	drug_target	
Octreotide	drug	
PDPK1	drug_target	
Risperidone	drug	
Ketoprofen	drug	
Estrone	drug	
DDC	drug_target	
PTGDR2	drug_target	
Perphenazine	drug	
SIGMAR1	drug_target	
ALB	drug_target	
ACSL4	drug_target	
PRSS1	drug_target	
HTR7	drug_target	
FGA	drug_target	
ITGA4	drug_target	
KIT	drug_target	
Abciximab	drug	
MMP9	drug_target	
SSTR3	drug_target	
IDE	drug_target	
SLC16A10	drug_target	
CYP2A13	drug_target	
CALM3	drug_target	
NR1I2	drug_target	
Aprotinin	drug	
ADRA1D	drug_target	
ABCC2	drug_target	
SLCO1A2	drug_target	
SCN5A	drug_target	
CACNA2D2	drug_target	
LRP1	drug_target	
SLC22A5	drug_target	
Epinephrine	drug	
PGR	drug_target	
VEGFA	drug_target	
PPARD	drug_target	
Amoxapine	drug	
ADRB3	drug_target	
HRH2	drug_target	
STAT5B	drug_target	
CREB1	drug_target	
LTA4H	drug_target	
Adenosine	drug	
HTR3A	drug_target	
ADORA2A	drug_target	
Hyaluronidase	drug	
HTR4	drug_target	
GLO1	drug_target	
PLAUR	drug_target	
Amitriptyline	drug	
PCSK1	drug_target	
HTR1B	drug_target	
Anterior myocardial infarction	phenotype	
ABCB1	drug_target	
Fluoxetine	drug	
PPAT	drug_target	
PAH	drug_target	
Rizatriptan	drug	
Insulin Human	drug	
ADK	drug_target	
FCGR3B	drug_target	
NOS2	drug_target	
ABCC3	drug_target	
Pentazocine	drug	
AGTR1	drug_target	
Rosiglitazone	drug	
SERPINB2	drug_target	
Bevacizumab	drug	
Danazol	drug	
Naproxen	drug	
MAOA	drug_target	
Methyltestosterone	drug	
HTR5A	drug_target	
Telmisartan	drug	
Tropicamide	drug	
Diphenhydramine	drug	
MAPK3	drug_target	
HRH3	drug_target	
SLC22A6	drug_target	
ABL1	drug_target	
Mirtazapine	drug	
ADA	drug_target	
Diclofenac	drug	
Dihydroergotamine	drug	
ANXA2	drug_target	
Naloxone	drug	
SLC10A1	drug_target	
Tolmetin	drug	
SULT2A1	drug_target	
Paroxetine	drug	
CYP3A4	drug_target	
ADRA1B	drug_target	
PLA2G2A	drug_target	
PTGR2	drug_target	
CLEC3B	drug_target	
Heparin	drug	
SCN4A	drug_target	
Imipramine	drug	
SERPINC1	drug_target	
Olanzapine	drug	
MMP2	drug_target	
GABRA1	drug_target	
Fenoldopam	drug	
Acute myocardial infarction	phenotype	
Enalaprilat	drug	
ABCA5	drug_target	
Ramipril	drug	
C1S	drug_target	
ABCC11	drug_target	
DRD2	drug_target	
Myocardial Infarction	phenotype	
MAOB	drug_target	
HTR1A	drug_target	
Pramipexole	drug	
Lisdexamfetamine	drug	
UGT1A6	drug_target	
HRH4	drug_target	
SLC6A4	drug_target	
GABRB2	drug_target	
CACNB2	drug_target	
ABCC10	drug_target	
Propranolol	drug	
CFTR	drug_target	
SLC22A8	drug_target	
PLAT	drug_target	
SLCO1B1	drug_target	
SSTR1	drug_target	
Irbesartan	drug	
Clonidine	drug	
Abiraterone	drug	
Pilocarpine	drug	
GRIN2B	drug_target	
TPH1	drug_target	
TRPM8	drug_target	
Nafarelin	drug	
HTR2B	drug_target	
TLR4	drug_target	
SCN2A	drug_target	
HDAC8	drug_target	
NFATC1	drug_target	
UGT1A10	drug_target	
OPRD1	drug_target	
LCK	drug_target	
TH	drug_target	
ADRB2	drug_target	
HDAC6	drug_target	
Frovatriptan	drug	
PLG	drug_target	
SLC28A1	drug_target	
Vorinostat	drug	
HDAC3	drug_target	
TAAR1	drug_target	
SERPINE1	drug_target	
ALOX5	drug_target	
BCAT1	drug_target	
BCL2	drug_target	
CYP2C19	drug_target	
Benazepril	drug	
VTN	drug_target	
THBD	drug_target	
CYP2A6	drug_target	
GRM5	drug_target	
Fondaparinux Sodium	drug	
UGT1A1	drug_target	
Zidovudine	drug	
IGF1R	drug_target	
Lisinopril	drug	
FKBP1A	drug_target	
Eletriptan	drug	
SMPD1	drug_target	
HDAC2	drug_target	
Nortriptyline	drug	
CYP3A43	drug_target	
KRT8	drug_target	
Glyburide	drug	
ITGA2B	drug_target	
Amphetamine	drug	
Pseudoephedrine	drug	
Tinzaparin	drug	
Tacrolimus	drug	
Goserelin	drug	
FCGR1A	drug_target	
Histrelin	drug	
FABP2	drug_target	
Progesterone	drug	
SELP	drug_target	
GSTP1	drug_target	
LHCGR	drug_target	
UGT1A3	drug_target	
ABCA1	drug_target	
OPRK1	drug_target	
AKR1C1	drug_target	
GRIN1	drug_target	
FCGR2B	drug_target	
GNRHR	drug_target	
NR0B1	drug_target	
CALR	drug_target	
ATP2C1	drug_target	
Acamprosate	drug	
ABCB11	drug_target	
SHBG	drug_target	
HTR6	drug_target	
Memantine	drug	
ABCC1	drug_target	
GABRB3	drug_target	
FMO3	drug_target	
NOV	drug_target	
Pergolide	drug	
CYP2C9	drug_target	
Almotriptan	drug	
F10	drug_target	
ESR1	drug_target	
CYP2C8	drug_target	
IGFBP7	drug_target	
C1QC	drug_target	
SLC15A2	drug_target	
Levodopa	drug	
CYP2D6	drug_target	
CHRM4	drug_target	
NR3C1	drug_target	
CYP2B6	drug_target	
Alteplase	drug	
CYP11B2	drug_target	
THRB	drug_target	
SLCO1B3	drug_target	
Piroxicam	drug	
KCND2	drug_target	
Trazodone	drug	
SLC18A2	drug_target	
Testosterone	drug	
Triptorelin	drug	
Candesartan	drug	
Infliximab	drug	
TYMS	drug_target	
ABCC9	drug_target	
ADRB1	drug_target	
PDGFRB	drug_target	
SLC22A1	drug_target	
SLC6A3	drug_target	
C1QA	drug_target	
Gabapentin	drug	
NOS3	drug_target	
FCGR2C	drug_target	
Prednisone	drug	
Olmesartan	drug	
PTGS2	drug_target	
SLC28A3	drug_target	
YES1	drug_target	
Enalapril	drug	
SLC7A5	drug_target	
HTR1D	drug_target	
ACHE	drug_target	
Old myocardial infarction	phenotype	
CYP19A1	drug_target	
Maprotiline	drug	
SLC29A2	drug_target	
TGFB1	drug_target	
ITGB3	drug_target	
Captopril	drug	
Nalbuphine	drug	
TERT	drug_target	
C1QB	drug_target	
TNF	drug_target	
FYN	drug_target	
GRIN2A	drug_target	
ADRA2B	drug_target	
Dasatinib	drug	
Erlotinib	drug	
KCNJ5	drug_target	
Phenylephrine	drug	
Fenoprofen	drug	
