Citalopram	drug	
PIK3CD	drug_target	
LYN	drug_target	
SLCO2B1	drug_target	
Atenolol	drug	
GLUL	drug_target	
Pancreatitis, Alcoholic	phenotype	
PPARG	drug_target	
Nintedanib	drug	
SLC7A8	drug_target	
HTR2A	drug_target	
Riluzole	drug	
ANXA1	drug_target	
CHRM5	drug_target	
CA2	drug_target	
MPO	drug_target	
UGT1A8	drug_target	
CYP17A1	drug_target	
ADRA2C	drug_target	
DDX39B	drug_target	
Trandolapril	drug	
ATP7A	drug_target	
ADORA1	drug_target	
HTR2C	drug_target	
RET	drug_target	
Quinapril	drug	
CANX	drug_target	
Sulfasalazine	drug	
CA12	drug_target	
DBH	drug_target	
SLC6A2	drug_target	
KDR	drug_target	
CACNA1B	drug_target	
FLT3	drug_target	
NQO1	drug_target	
Ropinirole	drug	
CYP2C18	drug_target	
SLC22A4	drug_target	
HTR1E	drug_target	
AR	drug_target	
SLCO1C1	drug_target	
ACP5	drug_target	
ABCC4	drug_target	
UGT1A4	drug_target	
ATP7B	drug_target	
KCNQ2	drug_target	
OPRM1	drug_target	
KCNH2	drug_target	
Atropine	drug	
CYP4A11	drug_target	
Pasireotide	drug	
Naltrexone	drug	
NFKB1	drug_target	
MT1A	drug_target	
PTGS1	drug_target	
SLC22A12	drug_target	
EGFR	drug_target	
ORM1	drug_target	
Fosinopril	drug	
Ibuprofen	drug	
SSTR2	drug_target	
DRD3	drug_target	
FAAH	drug_target	
Diphenoxylate	drug	
SRC	drug_target	
CHRM2	drug_target	
TTR	drug_target	
Dexamethasone	drug	
KCNH7	drug_target	
CYP1A2	drug_target	
Hydrochlorothiazide	drug	
FGFR1	drug_target	
UGT2B7	drug_target	
BCHE	drug_target	
GRIN3A	drug_target	
FLT1	drug_target	
DRD5	drug_target	
Morphine	drug	
SLC7A11	drug_target	
Tramadol	drug	
CHRM3	drug_target	
SLC22A3	drug_target	
CYP3A5	drug_target	
Eprosartan	drug	
ACE2	drug_target	
CRBN	drug_target	
Prilocaine	drug	
Donepezil	drug	
ADRA1A	drug_target	
GDF5	drug_target	
SLC22A2	drug_target	
Valsartan	drug	
ACE	drug_target	
UGT1A9	drug_target	
ADRA2A	drug_target	
UGT2B4	drug_target	
Acute pancreatitis	phenotype	
ABL2	drug_target	
Pancreatitis	phenotype	
RNGTT	drug_target	
Aripiprazole	drug	
Nadolol	drug	
KCNQ3	drug_target	
Estradiol	drug	
AKR1B1	drug_target	
Droxidopa	drug	
MTHFR	drug_target	
Losartan	drug	
ABCG2	drug_target	
Pancreatitis, Acute Necrotizing	phenotype	
CYP2E1	drug_target	
CA4	drug_target	
EPHA2	drug_target	
SLCO4A1	drug_target	
Acetaminophen	drug	
CYP1A1	drug_target	
ESR2	drug_target	
Propofol	drug	
CALY	drug_target	
CYP1B1	drug_target	
Quetiapine	drug	
Lanreotide	drug	
Clozapine	drug	
Oxaliplatin	drug	
ATM	drug_target	
Sulindac	drug	
DRD1	drug_target	
FGFR2	drug_target	
CCL2	drug_target	
CXCR1	drug_target	
ASIC1	drug_target	
KCNH6	drug_target	
MT2A	drug_target	
CHRM1	drug_target	
DRD4	drug_target	
Menthol	drug	
Ponatinib	drug	
SLC22A11	drug_target	
SSTR5	drug_target	
HRH1	drug_target	
CYP11A1	drug_target	
CD3D	drug_target	
TBXAS1	drug_target	
CES1	drug_target	
Tenecteplase	drug	
CHUK	drug_target	
PRSS2	drug_target	
CACNA2D1	drug_target	
Octreotide	drug	
Risperidone	drug	
Ketoprofen	drug	
Estrone	drug	
DDC	drug_target	
GM2A	drug_target	
SLC12A3	drug_target	
PTGDR2	drug_target	
SIGMAR1	drug_target	
ALB	drug_target	
SLC46A1	drug_target	
Caffeine	drug	
HTR7	drug_target	
KIT	drug_target	
FGA	drug_target	
GCH1	drug_target	
SSTR3	drug_target	
Hydroflumethiazide	drug	
SLC16A10	drug_target	
CA9	drug_target	
NR1I2	drug_target	
BCR	drug_target	
ADRA1D	drug_target	
ABCC2	drug_target	
SLCO1A2	drug_target	
SCN5A	drug_target	
CACNA2D2	drug_target	
LRP1	drug_target	
SLC22A5	drug_target	
PGR	drug_target	
VEGFA	drug_target	
PPARD	drug_target	
Amoxapine	drug	
ADRB3	drug_target	
STAT5B	drug_target	
HRH2	drug_target	
CREB1	drug_target	
ADORA2A	drug_target	
HTR3A	drug_target	
PLAUR	drug_target	
PRKDC	drug_target	
HTR1B	drug_target	
PDGFRA	drug_target	
ABCB1	drug_target	
CA1	drug_target	
PIK3CA	drug_target	
PAH	drug_target	
NOS2	drug_target	
Pentazocine	drug	
AGTR1	drug_target	
SERPINB2	drug_target	
Danazol	drug	
HTR5A	drug_target	
MAOA	drug_target	
Telmisartan	drug	
MAPK3	drug_target	
HRH3	drug_target	
SLC22A6	drug_target	
ABL1	drug_target	
Mirtazapine	drug	
GSTT1	drug_target	
Diclofenac	drug	
ANXA2	drug_target	
Naloxone	drug	
Erythromycin	drug	
SULT2A1	drug_target	
Paroxetine	drug	
MLNR	drug_target	
CYP3A4	drug_target	
ADRA1B	drug_target	
PLA2G2A	drug_target	
RYR1	drug_target	
SULT1A1	drug_target	
CLEC3B	drug_target	
SCN4A	drug_target	
Olanzapine	drug	
GABRA1	drug_target	
Enalaprilat	drug	
Ramipril	drug	
DRD2	drug_target	
PLA2G1B	drug_target	
HTR1A	drug_target	
Pramipexole	drug	
UGT1A6	drug_target	
HRH4	drug_target	
SLC6A4	drug_target	
GABRB2	drug_target	
ABCC10	drug_target	
Propranolol	drug	
CFTR	drug_target	
SLC22A8	drug_target	
PLAT	drug_target	
SLCO1B1	drug_target	
UGT2B15	drug_target	
SSTR1	drug_target	
Clonidine	drug	
Pilocarpine	drug	
GRIN2B	drug_target	
FMO1	drug_target	
TRPM8	drug_target	
TEK	drug_target	
MGST2	drug_target	
HTR2B	drug_target	
TLR4	drug_target	
SCN2A	drug_target	
Blinatumomab	drug	
GSTA2	drug_target	
OPRD1	drug_target	
LCK	drug_target	
UGT1A10	drug_target	
RNASE1	drug_target	
ADRB2	drug_target	
REN	drug_target	
PLG	drug_target	
Vandetanib	drug	
SERPINE1	drug_target	
ALOX5	drug_target	
BCAT1	drug_target	
BCL2	drug_target	
CYP2C19	drug_target	
Benazepril	drug	
THBD	drug_target	
CYP2A6	drug_target	
ACAT1	drug_target	
GRM5	drug_target	
UGT1A1	drug_target	
PTK6	drug_target	
Lisinopril	drug	
CYP3A43	drug_target	
KRT8	drug_target	
SULT1E1	drug_target	
Prazosin	drug	
SLC31A1	drug_target	
FABP2	drug_target	
GSTM1	drug_target	
GSTP1	drug_target	
PDE4B	drug_target	
FLT4	drug_target	
UGT1A3	drug_target	
OPRK1	drug_target	
NAT2	drug_target	
GRIN1	drug_target	
GNRHR	drug_target	
CALR	drug_target	
Hereditary pancreatitis	phenotype	
NR0B1	drug_target	
Acamprosate	drug	
ABCB11	drug_target	
SHBG	drug_target	
HTR6	drug_target	
Memantine	drug	
ABCC1	drug_target	
GABRB3	drug_target	
Capsaicin	drug	
FMO3	drug_target	
ATP1A1	drug_target	
PRDX6	drug_target	
Pergolide	drug	
CYP2C9	drug_target	
ESR1	drug_target	
CYP2C8	drug_target	
GSTA1	drug_target	
SLC15A2	drug_target	
CD19	drug_target	
Levodopa	drug	
CYP2D6	drug_target	
CHRM4	drug_target	
Aliskiren	drug	
TRPV1	drug_target	
NR3C1	drug_target	
CYP2B6	drug_target	
SLCO1B3	drug_target	
Isopropyl Alcohol	drug	
ADI1	drug_target	
Candesartan	drug	
IKBKB	drug_target	
ADRB1	drug_target	
PDGFRB	drug_target	
SLC22A1	drug_target	
SLC6A3	drug_target	
Gabapentin	drug	
Olmesartan	drug	
PTGS2	drug_target	
YES1	drug_target	
Enalapril	drug	
SLC7A5	drug_target	
HTR1D	drug_target	
ACHE	drug_target	
Busulfan	drug	
FGFR3	drug_target	
CYP19A1	drug_target	
DCXR	drug_target	
AHCY	drug_target	
PIK3CB	drug_target	
TNF	drug_target	
FYN	drug_target	
Thalidomide	drug	
GRIN2A	drug_target	
ADRA2B	drug_target	
Dasatinib	drug	
Erlotinib	drug	
FGFR4	drug_target	
KCNMA1	drug_target	
SOD1	drug_target	
Fenoprofen	drug	
