SLC7A11	drug_target	
UGT1A1	drug_target	
PPARD	drug_target	
ERBB2	drug_target	
IGF1R	drug_target	
CA5B	drug_target	
FKBP1A	drug_target	
SLC22A3	drug_target	
Probenecid	drug	
Hyaluronidase	drug	
CYP3A5	drug_target	
GLO1	drug_target	
PPARG	drug_target	
Indomethacin	drug	
SCN10A	drug_target	
SLC16A7	drug_target	
PCYT1B	drug_target	
Riluzole	drug	
Tetracycline	drug	
Prilocaine	drug	
Trastuzumab Emtansine	drug	
Trastuzumab	drug	
ABCB1	drug_target	
CA2	drug_target	
CA1	drug_target	
SLC22A2	drug_target	
ABCC6	drug_target	
PLD2	drug_target	
Insulin Detemir	drug	
SLC44A2	drug_target	
Tacrolimus	drug	
RXRG	drug_target	
FCGR3B	drug_target	
UGT1A9	drug_target	
ABCC3	drug_target	
PARP2	drug_target	
SLC44A4	drug_target	
SCN1B	drug_target	
Olaparib	drug	
FCGR1A	drug_target	
AOX1	drug_target	
MAOA	drug_target	
CA10	drug_target	
RARA	drug_target	
Vemurafenib	drug	
PADI4	drug_target	
MAPK3	drug_target	
SLC22A6	drug_target	
CA12	drug_target	
AKR1B1	drug_target	
SCN4B	drug_target	
Zonisamide	drug	
SLC44A3	drug_target	
CYP26A1	drug_target	
FCGR2B	drug_target	
Insulin Glargine	drug	
ABCC5	drug_target	
ABCG2	drug_target	
FCGR3A	drug_target	
CYP2C18	drug_target	
CA4	drug_target	
Sulfamethizole	drug	
ABCC1	drug_target	
SLC10A1	drug_target	
SLC22A4	drug_target	
RXRB	drug_target	
CEPT1	drug_target	
CYP3A4	drug_target	
Pertuzumab	drug	
CYP2C9	drug_target	
SLCO1C1	drug_target	
SLC5A7	drug_target	
CYP1A1	drug_target	
CYP2C8	drug_target	
PLA2G2A	drug_target	
PTGR2	drug_target	
ABCC4	drug_target	
PHOSPHO1	drug_target	
PPARA	drug_target	
C1QC	drug_target	
CA5A	drug_target	
SCN4A	drug_target	
PANX1	drug_target	
CYP1B1	drug_target	
BRAF	drug_target	
CYP2D6	drug_target	
CHDH	drug_target	
Sulindac	drug	
RARB	drug_target	
CYP2B6	drug_target	
SLC16A1	drug_target	
CA13	drug_target	
ABCA5	drug_target	
SLC44A1	drug_target	
C1S	drug_target	
ABCC11	drug_target	
Choline	drug	
MAOB	drug_target	
RARG	drug_target	
SLC22A11	drug_target	
CES1	drug_target	
CA6	drug_target	
PTGS1	drug_target	
SLC22A12	drug_target	
CHAT	drug_target	
RXRA	drug_target	
SLC22A1	drug_target	
EGFR	drug_target	
C1QA	drug_target	
SLC22A8	drug_target	
ORM1	drug_target	
FCGR2A	drug_target	
Peripheral neuropathy, myopathy, hoarseness, and hearing loss	phenotype	
CA3	drug_target	
FCGR2C	drug_target	
CACNA1I	drug_target	
SCN3A	drug_target	
PTGS2	drug_target	
SLC12A3	drug_target	
PTGDR2	drug_target	
PARP1	drug_target	
PARP3	drug_target	
ALB	drug_target	
ACHE	drug_target	
Insulin Lispro	drug	
INSR	drug_target	
PLD1	drug_target	
SCN2A	drug_target	
CYP19A1	drug_target	
Acitretin	drug	
TGFB1	drug_target	
CYP1A2	drug_target	
PRNP	drug_target	
CACNA1H	drug_target	
C1R	drug_target	
PCYT1A	drug_target	
CHKB	drug_target	
CA14	drug_target	
C1QB	drug_target	
CA7	drug_target	
RBP1	drug_target	
Hydrochlorothiazide	drug	
CA9	drug_target	
CHKA	drug_target	
NR1I2	drug_target	
CACNA1G	drug_target	
UGT2B7	drug_target	
ABCC2	drug_target	
Erlotinib	drug	
BCHE	drug_target	
SCN5A	drug_target	
SLCO1A2	drug_target	
CA8	drug_target	
CYP2C19	drug_target	
KCNMA1	drug_target	
SLC22A5	drug_target	
CYP2A6	drug_target	
SCN1A	drug_target	
Peripheral axonal neuropathy	phenotype	
Lidocaine	drug	
