UGT1A1	drug_target	
SLC7A11	drug_target	
SLCO2B1	drug_target	
Golimumab	drug	
Clopidogrel	drug	
PPARD	drug_target	
Tramadol	drug	
Amoxapine	drug	
CHRM3	drug_target	
HRH2	drug_target	
IL6R	drug_target	
HTR3A	drug_target	
ADAMTS4	drug_target	
Pneumonia	phenotype	
HTR4	drug_target	
CYP3A5	drug_target	
PPARG	drug_target	
KCND3	drug_target	
Amitriptyline	drug	
CYP3A43	drug_target	
SLC7A8	drug_target	
HTR2A	drug_target	
HTR1B	drug_target	
PLA2G4A	drug_target	
CCR5	drug_target	
CHRNA2	drug_target	
ANXA1	drug_target	
Eculizumab	drug	
ADRA1A	drug_target	
Balsalazide	drug	
Metoclopramide	drug	
ABCB1	drug_target	
CHRM5	drug_target	
SLC22A2	drug_target	
LTA	drug_target	
MPO	drug_target	
Aldesleukin	drug	
Amantadine	drug	
Tinzaparin	drug	
IL1R1	drug_target	
FCGR3B	drug_target	
ACE	drug_target	
Adalimumab	drug	
UGT1A9	drug_target	
ADRA2A	drug_target	
Community acquired pneumonia	phenotype	
CYP17A1	drug_target	
UGT2B4	drug_target	
NOS2	drug_target	
ADRA2C	drug_target	
FCGR1A	drug_target	
FABP2	drug_target	
ADORA1	drug_target	
HTR2C	drug_target	
IL2RB	drug_target	
Hydrocodone	drug	
MAOA	drug_target	
HTR5A	drug_target	
CHRNA3	drug_target	
Aripiprazole	drug	
Canakinumab	drug	
UGT1A3	drug_target	
Quinapril	drug	
Ziprasidone	drug	
Pimozide	drug	
Sulfasalazine	drug	
OPRK1	drug_target	
KCNQ3	drug_target	
Vigabatrin	drug	
Mirtazapine	drug	
HRH3	drug_target	
TNFRSF1B	drug_target	
SLC22A6	drug_target	
GRIN1	drug_target	
Zolmitriptan	drug	
FCGR2B	drug_target	
NR0B1	drug_target	
SLC6A2	drug_target	
ABCB11	drug_target	
ABCG2	drug_target	
CACNA1B	drug_target	
CYP2E1	drug_target	
HTR6	drug_target	
Ropinirole	drug	
Memantine	drug	
Certolizumab Pegol	drug	
CHRNA7	drug_target	
FCGR3A	drug_target	
GABBR1	drug_target	
ABCC1	drug_target	
CYP2C18	drug_target	
Treprostinil	drug	
CHRNA4	drug_target	
SLC22A4	drug_target	
ACAT1	drug_target	
HTR1E	drug_target	
Pneumocystis jiroveci pneumonia	phenotype	
FMO3	drug_target	
Pneumonia, Bacterial	phenotype	
Nefazodone	drug	
Paroxetine	drug	
Asenapine	drug	
CYP3A4	drug_target	
ADRA1B	drug_target	
CYP2C9	drug_target	
CHRNB2	drug_target	
Molindone	drug	
HTR1F	drug_target	
XDH	drug_target	
CYP1A1	drug_target	
CYP2C8	drug_target	
ABCC4	drug_target	
Apomorphine	drug	
C1QC	drug_target	
S100A4	drug_target	
TNNC1	drug_target	
SERPINC1	drug_target	
Olanzapine	drug	
CALY	drug_target	
CYP1B1	drug_target	
SLC15A2	drug_target	
UGT1A4	drug_target	
Quetiapine	drug	
Levodopa	drug	
GABRA1	drug_target	
Clozapine	drug	
CYP2D6	drug_target	
KCNQ2	drug_target	
CHRM4	drug_target	
OPRM1	drug_target	
Anakinra	drug	
Enalaprilat	drug	
PGRMC1	drug_target	
NR3C1	drug_target	
DRD1	drug_target	
CYP2B6	drug_target	
KCNH2	drug_target	
C5	drug_target	
PTGIR	drug_target	
IL2RA	drug_target	
Etanercept	drug	
C1S	drug_target	
CYP11B2	drug_target	
CHRM1	drug_target	
CYP4A11	drug_target	
Tetrabenazine	drug	
DRD4	drug_target	
KCND2	drug_target	
DRD2	drug_target	
Menthol	drug	
Naltrexone	drug	
MAOB	drug_target	
SLC18A2	drug_target	
Streptococcal pneumonia	phenotype	
Iloperidone	drug	
PLA2G1B	drug_target	
SLC22A11	drug_target	
SSTR5	drug_target	
NTRK2	drug_target	
Infliximab	drug	
HRH1	drug_target	
CYP11A1	drug_target	
TBXAS1	drug_target	
IKBKB	drug_target	
Maraviroc	drug	
NTRK1	drug_target	
HTR1A	drug_target	
Pramipexole	drug	
CES1	drug_target	
Oxymorphone	drug	
Lobar Pneumonia	phenotype	
PTGS1	drug_target	
IL1B	drug_target	
ADRB1	drug_target	
Fluphenazine	drug	
HRH4	drug_target	
SLC6A4	drug_target	
SLC22A1	drug_target	
SLC6A3	drug_target	
C1QA	drug_target	
CFTR	drug_target	
Gabapentin	drug	
SLC22A8	drug_target	
ORM1	drug_target	
PLAT	drug_target	
Trifluoperazine	drug	
CHUK	drug_target	
CBR1	drug_target	
SLCO1B1	drug_target	
Ibuprofen	drug	
FCGR2A	drug_target	
SSTR2	drug_target	
CACNA2D1	drug_target	
Octreotide	drug	
Risperidone	drug	
FCGR2C	drug_target	
KCNA1	drug_target	
Doxepin	drug	
DDC	drug_target	
PTGS2	drug_target	
SSTR1	drug_target	
DRD3	drug_target	
Pilocarpine	drug	
GRIN2B	drug_target	
Perphenazine	drug	
CHRNB4	drug_target	
TRPM8	drug_target	
Sumatriptan	drug	
SIGMAR1	drug_target	
ALB	drug_target	
SLC46A1	drug_target	
CHRM2	drug_target	
HTR1D	drug_target	
SLC7A5	drug_target	
HTR2B	drug_target	
Tiotropium	drug	
CYP19A1	drug_target	
Dexamethasone	drug	
HTR7	drug_target	
Dextromethorphan	drug	
ITGA4	drug_target	
CYP1A2	drug_target	
Fentanyl	drug	
OPRD1	drug_target	
Prochlorperazine	drug	
CXCL12	drug_target	
Tocilizumab	drug	
ADRB2	drug_target	
P2RY12	drug_target	
Promethazine	drug	
C1R	drug_target	
Remifentanil	drug	
SLC16A10	drug_target	
C1QB	drug_target	
CALM3	drug_target	
TNF	drug_target	
UGT2B7	drug_target	
GRIN2A	drug_target	
ALOX5	drug_target	
ADRA1D	drug_target	
ADRA2B	drug_target	
ABCC2	drug_target	
BCAT1	drug_target	
Buprenorphine	drug	
Basiliximab	drug	
SLCO1A2	drug_target	
Loxapine	drug	
BCL2	drug_target	
Trihexyphenidyl	drug	
CYP2C19	drug_target	
GRIN3A	drug_target	
CACNA2D2	drug_target	
THBD	drug_target	
CYP2A6	drug_target	
SLC22A5	drug_target	
IL2RG	drug_target	
DRD5	drug_target	
Pimavanserin	drug	
Codeine	drug	
