Etodolac	drug	
UGT1A1	drug_target	
SLCO2B1	drug_target	
PTK6	drug_target	
PPARD	drug_target	
STAT5B	drug_target	
LTA4H	drug_target	
GLO1	drug_target	
CYP3A5	drug_target	
PPARG	drug_target	
Indomethacin	drug	
ABCB1	drug_target	
Ramucirumab	drug	
ABCC6	drug_target	
Valsartan	drug	
UGT1A8	drug_target	
Celecoxib	drug	
Insulin Detemir	drug	
RXRG	drug_target	
ACE	drug_target	
UGT1A9	drug_target	
UGT2B4	drug_target	
ABCC3	drug_target	
ABL2	drug_target	
PRDX5	drug_target	
Perindopril	drug	
Trandolapril	drug	
AGTR1	drug_target	
FABP2	drug_target	
Flurbiprofen	drug	
Naproxen	drug	
RARA	drug_target	
Proteinuria, low molecular weight, with hypercalciuria and nephrocalcinosis	phenotype	
UGT1A3	drug_target	
MAPK3	drug_target	
ABL1	drug_target	
SLC22A6	drug_target	
AKR1B1	drug_target	
CYP26A1	drug_target	
MTHFR	drug_target	
Auranofin	drug	
Diflunisal	drug	
ABCG2	drug_target	
KDR	drug_target	
ABCC1	drug_target	
EPHA2	drug_target	
SLC10A1	drug_target	
RXRB	drug_target	
FMO3	drug_target	
CYP3A4	drug_target	
CYP2C9	drug_target	
CYP1A1	drug_target	
CYP2C8	drug_target	
PLA2G2A	drug_target	
PTGR2	drug_target	
ABCC4	drug_target	
PPARA	drug_target	
Proteinuria Adverse Event	phenotype	
CYP1B1	drug_target	
MMP2	drug_target	
SLC15A2	drug_target	
CYP2D6	drug_target	
Sulindac	drug	
RARB	drug_target	
Ramipril	drug	
SLCO1B3	drug_target	
Piroxicam	drug	
ABCC11	drug_target	
RARG	drug_target	
SLC22A11	drug_target	
IKBKB	drug_target	
CES1	drug_target	
PTGS1	drug_target	
RXRA	drug_target	
PDGFRB	drug_target	
EGFR	drug_target	
CFTR	drug_target	
SLC22A8	drug_target	
ORM1	drug_target	
PLAT	drug_target	
SLCO1B1	drug_target	
Ibuprofen	drug	
PDPK1	drug_target	
PTGS2	drug_target	
PTGDR2	drug_target	
FMO1	drug_target	
TEK	drug_target	
ALB	drug_target	
SRC	drug_target	
YES1	drug_target	
INSR	drug_target	
TTR	drug_target	
Oxcarbazepine	drug	
Acitretin	drug	
KIT	drug_target	
CYP1A2	drug_target	
Captopril	drug	
UGT1A10	drug_target	
LCK	drug_target	
MMP9	drug_target	
RBP1	drug_target	
Vandetanib	drug	
FYN	drug_target	
UGT2B7	drug_target	
ABCC2	drug_target	
Dasatinib	drug	
BCHE	drug_target	
SLCO1A2	drug_target	
BCL2	drug_target	
SCN5A	drug_target	
CYP2C19	drug_target	
Benazepril	drug	
THBD	drug_target	
VEGFA	drug_target	
