CYP2D6	drug_target	
Telmisartan	drug	
NPPB	drug_target	
UGT1A3	drug_target	
Enalaprilat	drug	
Quinapril	drug	
VEGFA	drug_target	
HIF1A	drug_target	
DRD1	drug_target	
SLC16A2	drug_target	
Lisinopril	drug	
SLC22A6	drug_target	
Enalapril	drug	
KCNH2	drug_target	
HTR1D	drug_target	
HTR2B	drug_target	
PTGIR	drug_target	
ACE2	drug_target	
Eprosartan	drug	
PPARG	drug_target	
TAT	drug_target	
YARS	drug_target	
SELE	drug_target	
HTR2A	drug_target	
HTR1B	drug_target	
SLCO1B3	drug_target	
ABCG2	drug_target	
NDUFC2	drug_target	
DRD4	drug_target	
DRD2	drug_target	
CYP1A2	drug_target	
VCAM1	drug_target	
PTGIS	drug_target	
CYP2E1	drug_target	
Ropinirole	drug	
ADRA1A	drug_target	
TH	drug_target	
ADRB2	drug_target	
ABCB1	drug_target	
Epoprostenol	drug	
SLC22A2	drug_target	
P2RY12	drug_target	
JUN	drug_target	
Candesartan	drug	
L-Tyrosine	drug	
High altitude pulmonary edema	phenotype	
CES1	drug_target	
YARS2	drug_target	
SLC16A10	drug_target	
Pramipexole	drug	
HTR1A	drug_target	
PTGS1	drug_target	
Carvedilol	drug	
ADRB1	drug_target	
ACE	drug_target	
Pergolide	drug	
CYP3A4	drug_target	
ADRA1B	drug_target	
ADRA2A	drug_target	
CYP2C9	drug_target	
SLC22A1	drug_target	
XDH	drug_target	
ADRA1D	drug_target	
CYP1A1	drug_target	
ADRA2C	drug_target	
ADRA2B	drug_target	
Fosinopril	drug	
SLC22A8	drug_target	
ABCC2	drug_target	
SLCO1A2	drug_target	
SLCO1B1	drug_target	
Trandolapril	drug	
CYP2C8	drug_target	
AGTR1	drug_target	
CYP2C19	drug_target	
HTR2C	drug_target	
GJA1	drug_target	
Olmesartan	drug	
DRD5	drug_target	
DRD3	drug_target	
SLC15A2	drug_target	
Pulmonary edema	phenotype	
Irbesartan	drug	
