SLC7A11	drug_target	
SLCO2B1	drug_target	
Golimumab	drug	
JAK3	drug_target	
CHRM3	drug_target	
HTR3A	drug_target	
CYP3A5	drug_target	
PPARG	drug_target	
HDAC2	drug_target	
SCN10A	drug_target	
PLA2G4A	drug_target	
HTR2A	drug_target	
HTR1B	drug_target	
GLRA3	drug_target	
Eculizumab	drug	
GARS	drug_target	
HCAR2	drug_target	
CHRM5	drug_target	
ABCB1	drug_target	
SLC22A2	drug_target	
LTA	drug_target	
MPO	drug_target	
Aldesleukin	drug	
FCGR3B	drug_target	
Severe Sepsis	phenotype	
Goserelin	drug	
ADRA2A	drug_target	
QPRT	drug_target	
SLC5A8	drug_target	
ADRA2C	drug_target	
FCGR1A	drug_target	
Ticlopidine	drug	
ADORA1	drug_target	
HTR2C	drug_target	
ALAS1	drug_target	
IL2RB	drug_target	
MAOA	drug_target	
Canakinumab	drug	
LHCGR	drug_target	
GCSH	drug_target	
HCAR3	drug_target	
Sulfasalazine	drug	
TNFRSF1B	drug_target	
SLC22A6	drug_target	
GLRA2	drug_target	
OPRK1	drug_target	
GRIN1	drug_target	
FCGR2B	drug_target	
GNRHR	drug_target	
SLC6A2	drug_target	
ABCG2	drug_target	
CACNA1B	drug_target	
CD80	drug_target	
SHMT1	drug_target	
CYP2E1	drug_target	
Cevimeline	drug	
Ropinirole	drug	
Memantine	drug	
Certolizumab Pegol	drug	
FCGR3A	drug_target	
BAAT	drug_target	
GLRA1	drug_target	
SLC16A3	drug_target	
GRIN3B	drug_target	
Niacin	drug	
SLC6A5	drug_target	
Paroxetine	drug	
CYP3A4	drug_target	
CYP2C9	drug_target	
SLC6A9	drug_target	
HTR1F	drug_target	
XDH	drug_target	
CYP1A1	drug_target	
CYP2C8	drug_target	
ABCC4	drug_target	
JAK2	drug_target	
C1QC	drug_target	
Glycine	drug	
GNMT	drug_target	
AGXT2	drug_target	
Tofacitinib	drug	
CYP2D6	drug_target	
Ibrutinib	drug	
CHRM4	drug_target	
OPRM1	drug_target	
CD86	drug_target	
DRD1	drug_target	
CYP2B6	drug_target	
C5	drug_target	
SLC16A1	drug_target	
CXCR1	drug_target	
AGXT	drug_target	
Sepsis	phenotype	
IL2RA	drug_target	
Etanercept	drug	
C1S	drug_target	
PDE3A	drug_target	
Atropine	drug	
CHRM1	drug_target	
DRD4	drug_target	
DRD2	drug_target	
NNMT	drug_target	
Menthol	drug	
PLA2G1B	drug_target	
SLC22A11	drug_target	
Infliximab	drug	
IKBKB	drug_target	
TBXAS1	drug_target	
HTR1A	drug_target	
Pramipexole	drug	
IL1B	drug_target	
PTGS1	drug_target	
GATM	drug_target	
SLC6A4	drug_target	
GLDC	drug_target	
SLC22A1	drug_target	
C1QA	drug_target	
SLC6A3	drug_target	
CHUK	drug_target	
Gabapentin	drug	
SLC22A8	drug_target	
JAK1	drug_target	
BTK	drug_target	
SLCO1B1	drug_target	
FCGR2A	drug_target	
CACNA2D1	drug_target	
Ketoprofen	drug	
FCGR2C	drug_target	
PTGS2	drug_target	
DRD3	drug_target	
GRIN2B	drug_target	
GRIN2C	drug_target	
SLC32A1	drug_target	
FMO1	drug_target	
GLRB	drug_target	
GCAT	drug_target	
TRPM8	drug_target	
Sumatriptan	drug	
ALB	drug_target	
Diphenoxylate	drug	
SHMT2	drug_target	
PIPOX	drug_target	
SLC46A1	drug_target	
CHRM2	drug_target	
HTR1D	drug_target	
HTR2B	drug_target	
Cocaine	drug	
GSS	drug_target	
CYP1A2	drug_target	
Fentanyl	drug	
OPRD1	drug_target	
Aminophylline	drug	
P2RY12	drug_target	
C1R	drug_target	
SLC16A10	drug_target	
C1QB	drug_target	
TNF	drug_target	
GRIN2A	drug_target	
ALOX5	drug_target	
ADRA2B	drug_target	
ABCC2	drug_target	
ALAS2	drug_target	
BCAT1	drug_target	
SLCO1A2	drug_target	
SCN5A	drug_target	
CACNA2D2	drug_target	
Abatacept	drug	
GRIN3A	drug_target	
CYP2C19	drug_target	
GLYAT	drug_target	
CYP2A6	drug_target	
ACAT1	drug_target	
SLC22A5	drug_target	
IL2RG	drug_target	
DRD5	drug_target	
GPR18	drug_target	
