Citalopram	drug	
Tramadol	drug	
HRH2	drug_target	
CHRM3	drug_target	
ADRB3	drug_target	
SLC22A3	drug_target	
HTR3A	drug_target	
Eletriptan	drug	
CYP3A5	drug_target	
KCND3	drug_target	
Amitriptyline	drug	
SELE	drug_target	
SLC7A8	drug_target	
HTR2A	drug_target	
HTR1B	drug_target	
ADRA1A	drug_target	
CHRM5	drug_target	
ABCB1	drug_target	
SLC22A2	drug_target	
ADRA2A	drug_target	
ADRA2C	drug_target	
HTR2C	drug_target	
Paliperidone	drug	
HTR5A	drug_target	
Nadolol	drug	
alcohol use disorder	phenotype	
OPRK1	drug_target	
KCNQ3	drug_target	
GRIN1	drug_target	
SLC6A2	drug_target	
Teduglutide	drug	
Lurasidone	drug	
HTR6	drug_target	
CYP2E1	drug_target	
Ropinirole	drug	
Memantine	drug	
CYP2C18	drug_target	
SLC22A4	drug_target	
HTR1E	drug_target	
FMO3	drug_target	
Paroxetine	drug	
Pergolide	drug	
CYP3A4	drug_target	
ADRA1B	drug_target	
Sotalol	drug	
Metoprolol	drug	
CYP2C9	drug_target	
HTR1F	drug_target	
XDH	drug_target	
CYP1A1	drug_target	
CYP2C8	drug_target	
Apomorphine	drug	
GJA1	drug_target	
Imipramine	drug	
Olanzapine	drug	
CALY	drug_target	
Levodopa	drug	
CYP2D6	drug_target	
KCNQ2	drug_target	
CHRM4	drug_target	
OPRM1	drug_target	
DRD1	drug_target	
CYP2B6	drug_target	
KCNH2	drug_target	
Salmeterol	drug	
CHRM1	drug_target	
KCND2	drug_target	
DRD4	drug_target	
DRD2	drug_target	
NTRK2	drug_target	
HRH1	drug_target	
Bisoprolol	drug	
NTRK1	drug_target	
HTR1A	drug_target	
Pramipexole	drug	
PTGS1	drug_target	
Carvedilol	drug	
ADRB1	drug_target	
HRH4	drug_target	
SLC6A4	drug_target	
SLC22A1	drug_target	
Propranolol	drug	
SLC6A3	drug_target	
ORM1	drug_target	
Risperidone	drug	
KCNA1	drug_target	
Doxepin	drug	
DDC	drug_target	
GLP2R	drug_target	
DRD3	drug_target	
GRIN2B	drug_target	
NPPB	drug_target	
Perphenazine	drug	
HIF1A	drug_target	
SIGMAR1	drug_target	
ALB	drug_target	
CHRM2	drug_target	
HTR1D	drug_target	
SLC7A5	drug_target	
HTR2B	drug_target	
HTR7	drug_target	
NDUFC2	drug_target	
CYP1A2	drug_target	
VCAM1	drug_target	
OPRD1	drug_target	
ADRB2	drug_target	
SLC16A10	drug_target	
CALM3	drug_target	
GRIN2A	drug_target	
ADRA1D	drug_target	
ADRA2B	drug_target	
Rotigotine	drug	
CYP2C19	drug_target	
GRIN3A	drug_target	
CYP2A6	drug_target	
DRD5	drug_target	
VEGFA	drug_target	
