Amoxapine	drug	
CHRM3	drug_target	
HRH2	drug_target	
HTR3A	drug_target	
Tardive Dyskinesia	phenotype	
CYP3A5	drug_target	
SMPD1	drug_target	
KCND3	drug_target	
Amitriptyline	drug	
Escitalopram	drug	
HTR2A	drug_target	
HTR1B	drug_target	
Haloperidol	drug	
Venlafaxine	drug	
ADRA1A	drug_target	
ABCB1	drug_target	
CHRM5	drug_target	
SLC22A2	drug_target	
Fluoxetine	drug	
UGT1A9	drug_target	
ADRA2A	drug_target	
ADRA2C	drug_target	
Chlorpromazine	drug	
HTR2C	drug_target	
Paliperidone	drug	
HTR5A	drug_target	
MAOA	drug_target	
CHRNA3	drug_target	
Aripiprazole	drug	
Bupropion	drug	
Ziprasidone	drug	
Pimozide	drug	
OPRK1	drug_target	
KCNQ3	drug_target	
Thioridazine	drug	
GRIN1	drug_target	
Zolmitriptan	drug	
Buspirone	drug	
SLC6A2	drug_target	
ABCB11	drug_target	
ABCG2	drug_target	
Lurasidone	drug	
CYP2E1	drug_target	
HTR6	drug_target	
CYP2C18	drug_target	
Memantine	drug	
HTR1E	drug_target	
FMO3	drug_target	
Asenapine	drug	
CYP3A4	drug_target	
ADRA1B	drug_target	
CYP2C9	drug_target	
Molindone	drug	
HTR1F	drug_target	
CYP1A1	drug_target	
CYP2C8	drug_target	
Olanzapine	drug	
CALY	drug_target	
CYP1B1	drug_target	
UGT1A4	drug_target	
Quetiapine	drug	
GABRA1	drug_target	
Clozapine	drug	
CYP2D6	drug_target	
KCNQ2	drug_target	
CHRM4	drug_target	
OPRM1	drug_target	
DRD1	drug_target	
CYP2B6	drug_target	
KCNH2	drug_target	
CHRM1	drug_target	
Tetrabenazine	drug	
KCND2	drug_target	
DRD4	drug_target	
DRD2	drug_target	
Trazodone	drug	
MAOB	drug_target	
Iloperidone	drug	
SLC18A2	drug_target	
Selegiline	drug	
NTRK2	drug_target	
HRH1	drug_target	
NTRK1	drug_target	
HTR1A	drug_target	
ADRB1	drug_target	
Fluphenazine	drug	
HRH4	drug_target	
SLC6A4	drug_target	
SLC22A1	drug_target	
SLC6A3	drug_target	
ORM1	drug_target	
CBR1	drug_target	
Risperidone	drug	
KCNA1	drug_target	
Fluvoxamine	drug	
Doxepin	drug	
DRD3	drug_target	
GRIN2B	drug_target	
Perphenazine	drug	
SIGMAR1	drug_target	
ALB	drug_target	
CHRM2	drug_target	
HTR1D	drug_target	
HTR2B	drug_target	
Thiothixene	drug	
HTR7	drug_target	
CYP1A2	drug_target	
OPRD1	drug_target	
Prochlorperazine	drug	
ADRB2	drug_target	
CALM3	drug_target	
GRIN2A	drug_target	
ADRA1D	drug_target	
ADRA2B	drug_target	
BCHE	drug_target	
Loxapine	drug	
Trihexyphenidyl	drug	
CYP2C19	drug_target	
GRIN3A	drug_target	
CYP2A6	drug_target	
DRD5	drug_target	
