UGT1A1	drug_target	
LYN	drug_target	
PTK6	drug_target	
MMACHC	drug_target	
Peginterferon Alfa-2a	drug	
ERBB2	drug_target	
STAT5B	drug_target	
TCN1	drug_target	
CYP3A5	drug_target	
Nintedanib	drug	
Thrombocytopenia, platelet dysfunction, hemolysis, and imbalanced globin synthesis	phenotype	
PDGFRA	drug_target	
SLC29A1	drug_target	
MAP2K1	drug_target	
IFNGR2	drug_target	
FGF4	drug_target	
Trastuzumab	drug	
ABCB1	drug_target	
SLC22A2	drug_target	
CSF1R	drug_target	
ITGA2B	drug_target	
MUT	drug_target	
MPO	drug_target	
ITK	drug_target	
FCGR3B	drug_target	
TCN2	drug_target	
ABL2	drug_target	
PRDX5	drug_target	
FCGR1A	drug_target	
MAP2K2	drug_target	
IFNAR1	drug_target	
FLT4	drug_target	
Ofatumumab	drug	
RET	drug_target	
AMN	drug_target	
ABL1	drug_target	
SLC22A6	drug_target	
PNP	drug_target	
MAP3K2	drug_target	
Imatinib	drug	
Autoimmune thrombocytopenia	phenotype	
FCGR2B	drug_target	
MTHFR	drug_target	
Olsalazine	drug	
Auranofin	drug	
ABCB11	drug_target	
ABCG2	drug_target	
KDR	drug_target	
FLT3	drug_target	
Ruxolitinib	drug	
FCGR3A	drug_target	
ABCC1	drug_target	
EPHA2	drug_target	
FGF1	drug_target	
Pentosan Polysulfate	drug	
FMO3	drug_target	
MMAA	drug_target	
CYP3A4	drug_target	
GIF	drug_target	
CYP2C9	drug_target	
CYP1A1	drug_target	
Bosutinib	drug	
CYP2C8	drug_target	
ABCC4	drug_target	
JAK2	drug_target	
Interferon Beta-1B	drug	
C1QC	drug_target	
Aminosalicylic Acid	drug	
DDR1	drug_target	
IFNGR1	drug_target	
CYP1B1	drug_target	
CD19	drug_target	
ABCA3	drug_target	
CUBN	drug_target	
CYP2D6	drug_target	
FGFR2	drug_target	
Interferon Gamma-1b	drug	
C1S	drug_target	
FGF2	drug_target	
MS4A1	drug_target	
Sunitinib	drug	
Ponatinib	drug	
MTR	drug_target	
IKBKB	drug_target	
CD3D	drug_target	
NTRK1	drug_target	
PTGS1	drug_target	
PDGFRB	drug_target	
SLC22A1	drug_target	
EGFR	drug_target	
C1QA	drug_target	
CHUK	drug_target	
JAK1	drug_target	
ORM1	drug_target	
CAMK2G	drug_target	
SLCO1B1	drug_target	
FCGR2A	drug_target	
Didanosine	drug	
Tirofiban	drug	
FCGR2C	drug_target	
HCK	drug_target	
PTGS2	drug_target	
IFNG	drug_target	
IFNAR2	drug_target	
FMO1	drug_target	
TEK	drug_target	
ALB	drug_target	
SRC	drug_target	
YES1	drug_target	
FGFR3	drug_target	
SLC29A2	drug_target	
CYP19A1	drug_target	
Blinatumomab	drug	
MMAB	drug_target	
KIT	drug_target	
ITGB3	drug_target	
CYP1A2	drug_target	
Interferon Alfacon-1	drug	
MTRR	drug_target	
CDK2	drug_target	
Abciximab	drug	
LCK	drug_target	
C1R	drug_target	
SH2B3	drug_target	
C1QB	drug_target	
Interferon Beta-1A	drug	
Vandetanib	drug	
FGFR1	drug_target	
PLA2G2E	drug_target	
BCR	drug_target	
FYN	drug_target	
TPMT	drug_target	
ALOX5	drug_target	
Cyanocobalamin	drug	
ABCC2	drug_target	
Dasatinib	drug	
FGFR4	drug_target	
Pazopanib	drug	
CYP2C19	drug_target	
VTN	drug_target	
FLT1	drug_target	
VEGFA	drug_target	
