Tiopronin	drug	
MPO	drug_target	
Agranulocytosis	phenotype	
Cefaclor	drug	
SLC15A2	drug_target	
Blinatumomab	drug	
CD3D	drug_target	
CD19	drug_target	
Filgrastim	drug	
CSF3R	drug_target	
ELANE	drug_target	
Tolmetin	drug	
PTGS2	drug_target	
PTGS1	drug_target	
SLC22A6	drug_target	
TDO2	drug_target	
HLA-DQB2	intermediate	
HLA-DRB4	intermediate	
HLA-DRB1	intermediate	
HLA-DQB1	intermediate	
GRB2	intermediate	
TP53	intermediate	
