Epinephrine	drug	
TNF	drug_target	
CYP1A2	drug_target	
CYP3A4	drug_target	
CYP2C9	drug_target	
PAH	drug_target	
SLC22A2	drug_target	
SLC22A1	drug_target	
SLC22A5	drug_target	
ADRB1	drug_target	
ADRB2	drug_target	
ADRA1A	drug_target	
ADRA1B	drug_target	
ADRA1D	drug_target	
ADRA2A	drug_target	
ADRA2B	drug_target	
ADRA2C	drug_target	
ADRB3	drug_target	
Cardiac arrest	phenotype	
Chlorpromazine	drug	
CYP2D6	drug_target	
ABCB1	drug_target	
CYP2E1	drug_target	
ALB	drug_target	
BCHE	drug_target	
ABCB11	drug_target	
DRD2	drug_target	
CHRM3	drug_target	
CHRM1	drug_target	
HTR2C	drug_target	
KCNH2	drug_target	
HRH1	drug_target	
HTR1A	drug_target	
HTR7	drug_target	
HTR2A	drug_target	
DRD1	drug_target	
DRD5	drug_target	
DRD3	drug_target	
DRD4	drug_target	
HTR6	drug_target	
HRH4	drug_target	
SMPD1	drug_target	
CALM3	drug_target	
Isoflurane	drug	
GRIA1	drug_target	
GLRA1	drug_target	
MT-ND1	drug_target	
CYP2B6	drug_target	
KCNA1	drug_target	
ATP2C1	drug_target	
ATP5D	drug_target	
GABRA1	drug_target	
Sotalol	drug	
Calcium	drug	
CACNA1C	drug_target	
S100B	drug_target	
TNNC1	drug_target	
TNNC2	drug_target	
SPTBN1	drug_target	
CAST	drug_target	
COMP	drug_target	
Disopyramide	drug	
SCN5A	drug_target	
CHRM2	drug_target	
KCND2	drug_target	
KCND3	drug_target	
ORM1	drug_target	
Hyaluronidase	drug	
TGFB1	drug_target	
PMCH	intermediate	
APOB	intermediate	
P2RY11	intermediate	
APOE	intermediate	
EDN1	intermediate	
SCT	intermediate	
APP	intermediate	
TNFRSF1A	intermediate	
complex:lAo9+jzjVOaRJSWZQvoh0G1mUDc	intermediate	
TFRC	intermediate	
GNG2	intermediate	
GNAS	intermediate	
GNB1	intermediate	
GCGR	intermediate	
NPSR1	intermediate	
GNAI2	intermediate	
LDLR	intermediate	
NPS	intermediate	
CCL23	intermediate	
RLN3	intermediate	
GCG	intermediate	
SPAST	intermediate	
SAA1	intermediate	
POMC	intermediate	
LDLRAP1	intermediate	
NMUR1	intermediate	
PPP3CA	intermediate	
BDKRB2	intermediate	
LPAR1	intermediate	
CASR	intermediate	
GPR17	intermediate	
AKT1	intermediate	
NMU	intermediate	
BDKRB1	intermediate	
CXCL8	intermediate	
PDYN	intermediate	
KNG1	intermediate	
CCL5	intermediate	
RYR2	intermediate	
NMUR2	intermediate	
AGT	intermediate	
LPAR2	intermediate	
GABBR1	intermediate	
TTR	intermediate	
ACTN2	intermediate	
NMS	intermediate	
LPAR5	intermediate	
PPBP	intermediate	
LPAR3	intermediate	
PRKCG	intermediate	
NDUFB11	intermediate	
ANK2	intermediate	
HRAS	intermediate	
INS	intermediate	
GRB2	intermediate	
SPTBN2	intermediate	
SOS1	intermediate	
PPP1R15A	intermediate	
TGFBR2	intermediate	
TGFBR1	intermediate	
