Tranexamic Acid	drug	
PLG	drug_target	
SLC15A2	drug_target	
Ischaemic cerebral infarction	phenotype	
Ziprasidone	drug	
CYP1A2	drug_target	
CYP2D6	drug_target	
CYP3A4	drug_target	
CYP3A5	drug_target	
DRD2	drug_target	
CHRM3	drug_target	
CHRM1	drug_target	
HTR2C	drug_target	
CHRM2	drug_target	
ADRA1A	drug_target	
ADRA1B	drug_target	
HRH1	drug_target	
HTR1D	drug_target	
HTR1B	drug_target	
HTR1A	drug_target	
HTR1E	drug_target	
HTR7	drug_target	
HTR2A	drug_target	
DRD1	drug_target	
DRD5	drug_target	
DRD3	drug_target	
DRD4	drug_target	
HTR3A	drug_target	
HTR6	drug_target	
ADRA2A	drug_target	
ADRA2B	drug_target	
ADRA2C	drug_target	
CHRM4	drug_target	
CHRM5	drug_target	
Infarction, Middle Cerebral Artery	phenotype	
Tenecteplase	drug	
FGA	drug_target	
PLAUR	drug_target	
SERPINE1	drug_target	
SERPINB2	drug_target	
CALR	drug_target	
CANX	drug_target	
LRP1	drug_target	
CLEC3B	drug_target	
KRT8	drug_target	
ANXA2	drug_target	
Reteplase	drug	
Cabozantinib	drug	
CYP2C9	drug_target	
KDR	drug_target	
RET	drug_target	
MET	drug_target	
Pramipexole	drug	
SLC22A2	drug_target	
SLC22A1	drug_target	
HTR2B	drug_target	
Alteplase	drug	
PLAU	intermediate	
PLAT	intermediate	
NMUR1	intermediate	
PMCH	intermediate	
CXCL2	intermediate	
BDKRB2	intermediate	
LPAR1	intermediate	
APOE	intermediate	
EDN1	intermediate	
P2RY11	intermediate	
CASR	intermediate	
CXCR3	intermediate	
GPR17	intermediate	
APP	intermediate	
complex:lAo9+jzjVOaRJSWZQvoh0G1mUDc	intermediate	
GNG2	intermediate	
NMU	intermediate	
GNB1	intermediate	
BDKRB1	intermediate	
GHSR	intermediate	
GCGR	intermediate	
GHRL	intermediate	
KNG1	intermediate	
NPSR1	intermediate	
C3	intermediate	
ADORA1	intermediate	
NMUR2	intermediate	
AGT	intermediate	
LPAR2	intermediate	
CCL23	intermediate	
NPS	intermediate	
RLN3	intermediate	
GCG	intermediate	
NMS	intermediate	
LPAR5	intermediate	
CRH	intermediate	
LPAR3	intermediate	
SAA1	intermediate	
POMC	intermediate	
FGB	intermediate	
VWF	intermediate	
PTK2	intermediate	
HBEGF	intermediate	
PIK3CA	intermediate	
GDNF	intermediate	
ANGPT1	intermediate	
SOS1	intermediate	
ARTN	intermediate	
CSF2	intermediate	
FGF2	intermediate	
CALM3	intermediate	
PSPN	intermediate	
CDC42	intermediate	
HGF	intermediate	
PIK3CB	intermediate	
PIK3R1	intermediate	
DLG4	intermediate	
CRK	intermediate	
CCR6	intermediate	
TAS2R40	intermediate	
CCR3	intermediate	
CCR5	intermediate	
HTR1F	intermediate	
TAS2R20	intermediate	
PTGDR	intermediate	
S1PR1	intermediate	
NPBWR1	intermediate	
PTGER1	intermediate	
NPY4R	intermediate	
GABBR2	intermediate	
TAS2R16	intermediate	
TAS2R60	intermediate	
CCL21	intermediate	
FPR2	intermediate	
FPR1	intermediate	
GPR55	intermediate	
GRM2	intermediate	
NPB	intermediate	
HEBP1	intermediate	
PDYN	intermediate	
CXCR4	intermediate	
CCL5	intermediate	
CCL16	intermediate	
HTR5A	intermediate	
OPRK1	intermediate	
TAS2R7	intermediate	
TAS2R43	intermediate	
TAS2R4	intermediate	
GRM8	intermediate	
CCR1	intermediate	
SUCNR1	intermediate	
TAS2R8	intermediate	
S1PR2	intermediate	
PPY	intermediate	
SSTR5	intermediate	
CXCL5	intermediate	
RXFP4	intermediate	
CXCR1	intermediate	
S1PR5	intermediate	
PPBP	intermediate	
TAS2R41	intermediate	
C5	intermediate	
APOB	intermediate	
PF4	intermediate	
TBXA2R	intermediate	
GPR18	intermediate	
CXCL3	intermediate	
TAS2R45	intermediate	
CXCL11	intermediate	
TAS2R46	intermediate	
CXCL6	intermediate	
SSTR4	intermediate	
TAS2R50	intermediate	
NPY2R	intermediate	
EDNRB	intermediate	
MGST1	intermediate	
CNR2	intermediate	
CXCR2	intermediate	
P2RY13	intermediate	
CXCR5	intermediate	
CXCL13	intermediate	
F2RL3	intermediate	
GRM6	intermediate	
CCL28	intermediate	
RAMP2	intermediate	
CCR2	intermediate	
C5AR1	intermediate	
INSL5	intermediate	
ADORA3	intermediate	
HRH3	intermediate	
GRM4	intermediate	
MGST3	intermediate	
CXCL16	intermediate	
MT-RNR2	intermediate	
ADM	intermediate	
OPRL1	intermediate	
APLNR	intermediate	
TAS2R9	intermediate	
NPBWR2	intermediate	
P2RY4	intermediate	
CCR7	intermediate	
MCHR1	intermediate	
HCAR2	intermediate	
GNAI1	intermediate	
HCAR3	intermediate	
GALR3	intermediate	
F2R	intermediate	
TAS2R31	intermediate	
TAS2R19	intermediate	
CXCL9	intermediate	
FPR3	intermediate	
ANXA1	intermediate	
GNAT3	intermediate	
NPY1R	intermediate	
CXCL8	intermediate	
GNAI3	intermediate	
AGTR2	intermediate	
PNOC	intermediate	
S1PR4	intermediate	
CXCL10	intermediate	
TAS2R3	intermediate	
TAS2R1	intermediate	
TAS2R14	intermediate	
MCHR2	intermediate	
TAS2R10	intermediate	
NPY	intermediate	
PTGER3	intermediate	
CCR10	intermediate	
F2	intermediate	
OXER1	intermediate	
PENK	intermediate	
CXCL1	intermediate	
GALR2	intermediate	
P2RY12	intermediate	
CXCR6	intermediate	
CCR8	intermediate	
NPY5R	intermediate	
GAL	intermediate	
S1PR3	intermediate	
C3AR1	intermediate	
TAS2R39	intermediate	
SSTR1	intermediate	
CORT	intermediate	
SSTR3	intermediate	
TAS2R38	intermediate	
SSTR2	intermediate	
CCL20	intermediate	
GALR1	intermediate	
MTNR1B	intermediate	
PYY	intermediate	
OXGR1	intermediate	
ACKR3	intermediate	
TAS2R5	intermediate	
HCAR1	intermediate	
TAS2R30	intermediate	
CXCL12	intermediate	
P2RY14	intermediate	
RXFP3	intermediate	
PTGDR2	intermediate	
RAMP1	intermediate	
MTNR1A	intermediate	
GPER1	intermediate	
APLN	intermediate	
OPRD1	intermediate	
GNAI2	intermediate	
GRM7	intermediate	
GABBR1	intermediate	
LDLR	intermediate	
HRH4	intermediate	
GFAP	intermediate	
SST	intermediate	
TAS2R42	intermediate	
CCR4	intermediate	
CCL27	intermediate	
CCR9	intermediate	
CCL25	intermediate	
NPW	intermediate	
MGST2	intermediate	
P2RY2	intermediate	
CCL19	intermediate	
CNR1	intermediate	
