Telmisartan	drug	
ABCB1	drug_target	
ABCC2	drug_target	
CYP2C19	drug_target	
ABCG2	drug_target	
PPARG	drug_target	
AGTR1	drug_target	
High altitude pulmonary edema	phenotype	
Vandetanib	drug	
EGFR	drug_target	
CYP3A4	drug_target	
ALB	drug_target	
ABCC1	drug_target	
VEGFA	drug_target	
FMO1	drug_target	
FMO3	drug_target	
ORM1	drug_target	
TEK	drug_target	
PTK6	drug_target	
Pulmonary edema	phenotype	
Olmesartan	drug	
SLCO1B1	drug_target	
SLCO1B3	drug_target	
Benazepril	drug	
MTHFR	drug_target	
ACE	drug_target	
SLC15A2	drug_target	
Pergolide	drug	
CYP2D6	drug_target	
DRD2	drug_target	
HTR2C	drug_target	
ADRA1A	drug_target	
ADRA1B	drug_target	
ADRA1D	drug_target	
HTR1D	drug_target	
HTR1B	drug_target	
HTR1A	drug_target	
HTR2B	drug_target	
HTR2A	drug_target	
DRD1	drug_target	
DRD5	drug_target	
DRD3	drug_target	
DRD4	drug_target	
ADRA2A	drug_target	
ADRA2B	drug_target	
ADRA2C	drug_target	
Fosinopril	drug	
Quinapril	drug	
Eprosartan	drug	
CYP2C9	drug_target	
Irbesartan	drug	
CYP1A2	drug_target	
PTGS1	drug_target	
CYP2C8	drug_target	
UGT1A3	drug_target	
JUN	drug_target	
Meclofenamic acid	drug	
PTGS2	drug_target	
SLC22A6	drug_target	
ALOX5	drug_target	
SLCO1C1	drug_target	
KCNQ2	drug_target	
KCNQ3	drug_target	
Cabergoline	drug	
ADRB1	drug_target	
ADRB2	drug_target	
HTR7	drug_target	
Treprostinil	drug	
PPARD	drug_target	
P2RY12	drug_target	
PTGIR	drug_target	
Carvedilol	drug	
XDH	drug_target	
CYP2E1	drug_target	
NDUFC2	drug_target	
CYP1A1	drug_target	
KCNH2	drug_target	
VCAM1	drug_target	
NPPB	drug_target	
GJA1	drug_target	
SELE	drug_target	
HIF1A	drug_target	
Infliximab	drug	
TNF	drug_target	
Periorbital edema	phenotype	
Ramipril	drug	
BCHE	drug_target	
Epoprostenol	drug	
PTGIS	drug_target	
Dicyclomine	drug	
CHRM1	drug_target	
CHRM2	drug_target	
Phendimetrazine	drug	
SLC6A2	drug_target	
Cerebral edema	phenotype	
Desmopressin	drug	
AVPR2	drug_target	
AVPR1A	drug_target	
AVPR1B	drug_target	
Diflunisal	drug	
UGT1A8	drug_target	
TTR	drug_target	
Octreotide	drug	
MPO	drug_target	
SSTR1	drug_target	
SSTR5	drug_target	
SSTR2	drug_target	
Trandolapril	drug	
CES1	drug_target	
Repaglinide	drug	
ABCC8	drug_target	
Quetiapine	drug	
CYP3A5	drug_target	
CHRM3	drug_target	
HRH1	drug_target	
HTR1E	drug_target	
HTR3A	drug_target	
HTR6	drug_target	
CHRM4	drug_target	
CHRM5	drug_target	
Cefaclor	drug	
Pentoxifylline	drug	
PDE4B	drug_target	
ADORA1	drug_target	
ADORA2A	drug_target	
PDE5A	drug_target	
PDE4A	drug_target	
NT5E	drug_target	
L-Tyrosine	drug	
TAT	drug_target	
SLC16A10	drug_target	
SLC16A2	drug_target	
TH	drug_target	
YARS2	drug_target	
YARS	drug_target	
Oxymetholone	drug	
MAOA	drug_target	
SRD5A1	drug_target	
AR	drug_target	
SHBG	drug_target	
Insulin Detemir	drug	
INSR	drug_target	
Levocetirizine	drug	
Aminocaproic Acid	drug	
PLG	drug_target	
PLAT	drug_target	
AOX1	drug_target	
Apomorphine	drug	
CALY	drug_target	
Erythromycin	drug	
SLCO1A2	drug_target	
CYP2B6	drug_target	
MLNR	drug_target	
Lisinopril	drug	
ACE2	drug_target	
Cyproheptadine	drug	
Ropinirole	drug	
Fenoprofen	drug	
Capsaicin	drug	
GLUL	drug_target	
DBH	drug_target	
TRPV1	drug_target	
Levodopa	drug	
DDC	drug_target	
SLC7A8	drug_target	
SLC7A5	drug_target	
Bromocriptine	drug	
Perphenazine	drug	
CYP2C18	drug_target	
CALM3	drug_target	
Facial edema	phenotype	
Ampicillin	drug	
SLC16A1	drug_target	
SLC22A5	drug_target	
Paliperidone	drug	
Modafinil	drug	
SLC6A3	drug_target	
Hyaluronidase	drug	
TGFB1	drug_target	
Maprotiline	drug	
Dexpanthenol	drug	
Pindolol	drug	
Pramipexole	drug	
SLC22A2	drug_target	
SLC22A1	drug_target	
Gatifloxacin	drug	
Loxapine	drug	
SLC6A4	drug_target	
HRH2	drug_target	
HRH4	drug_target	
HTR5A	drug_target	
Perindopril	drug	
EDN1	intermediate	
EDNRA	intermediate	
ROCK1	intermediate	
PIK3R1	intermediate	
NRG1	intermediate	
SRC	intermediate	
IL2	intermediate	
PIK3CA	intermediate	
PIK3R2	intermediate	
PTK2	intermediate	
complex:lAo9+jzjVOaRJSWZQvoh0G1mUDc	intermediate	
LAT	intermediate	
FGF7	intermediate	
HSP90AA1	intermediate	
FGF10	intermediate	
PIK3CB	intermediate	
FYN	intermediate	
REN	intermediate	
GCG	intermediate	
GPR17	intermediate	
AGT	intermediate	
KNG1	intermediate	
RLN3	intermediate	
F2R	intermediate	
LPAR3	intermediate	
POMC	intermediate	
GCGR	intermediate	
SAA1	intermediate	
NPS	intermediate	
NMU	intermediate	
NMUR2	intermediate	
PMCH	intermediate	
NMUR1	intermediate	
CCL23	intermediate	
FSHR	intermediate	
CASR	intermediate	
NPSR1	intermediate	
APP	intermediate	
GNB1	intermediate	
BDKRB1	intermediate	
FPR1	intermediate	
P2RY11	intermediate	
CCR5	intermediate	
LPAR2	intermediate	
LPAR1	intermediate	
GHRH	intermediate	
NMS	intermediate	
BDKRB2	intermediate	
CXCL2	intermediate	
GNG2	intermediate	
CXCL8	intermediate	
LPAR5	intermediate	
TSHR	intermediate	
VIPR2	intermediate	
GPR27	intermediate	
GIP	intermediate	
RXFP1	intermediate	
CRHR1	intermediate	
RAMP1	intermediate	
PTH	intermediate	
CRH	intermediate	
ADM	intermediate	
PTHLH	intermediate	
TAAR1	intermediate	
GPR32	intermediate	
MC2R	intermediate	
GHRHR	intermediate	
GPR83	intermediate	
VIP	intermediate	
LHB	intermediate	
PTH1R	intermediate	
PTGDR	intermediate	
PTGER4	intermediate	
PTGER2	intermediate	
GPR150	intermediate	
GPBAR1	intermediate	
SCT	intermediate	
TSHB	intermediate	
ADM2	intermediate	
RAMP3	intermediate	
VIPR1	intermediate	
CALCA	intermediate	
GPHB5	intermediate	
GIPR	intermediate	
ADCYAP1	intermediate	
IAPP	intermediate	
LHCGR	intermediate	
CGA	intermediate	
ADORA2B	intermediate	
RAMP2	intermediate	
MC1R	intermediate	
GPR84	intermediate	
PTH2	intermediate	
HTR4	intermediate	
GPHA2	intermediate	
GPR45	intermediate	
GLP2R	intermediate	
INSL3	intermediate	
PTH2R	intermediate	
CALCRL	intermediate	
MC3R	intermediate	
GNAS	intermediate	
ADCYAP1R1	intermediate	
RLN2	intermediate	
CALCR	intermediate	
FSHB	intermediate	
GPR176	intermediate	
GPR20	intermediate	
MC5R	intermediate	
RXFP2	intermediate	
CALCB	intermediate	
SCTR	intermediate	
ADRB3	intermediate	
GPR25	intermediate	
GPR15	intermediate	
EGLN1	intermediate	
UBC	intermediate	
TNFRSF1A	intermediate	
SLC25A13	intermediate	
GFAP	intermediate	
APOE	intermediate	
F2	intermediate	
AVP	intermediate	
MYL4	intermediate	
DMD	intermediate	
TAS2R50	intermediate	
CXCL10	intermediate	
CNR1	intermediate	
CCL16	intermediate	
MCHR1	intermediate	
TAS2R46	intermediate	
CXCL3	intermediate	
CXCL11	intermediate	
TAS2R40	intermediate	
CNR2	intermediate	
GRM7	intermediate	
CXCR5	intermediate	
HRH3	intermediate	
GABBR1	intermediate	
ADORA3	intermediate	
S1PR1	intermediate	
HEBP1	intermediate	
NPW	intermediate	
CCR10	intermediate	
CCL28	intermediate	
NPY4R	intermediate	
TAS2R4	intermediate	
HCAR2	intermediate	
CXCL16	intermediate	
PF4	intermediate	
TAS2R60	intermediate	
PPBP	intermediate	
TAS2R7	intermediate	
CCR3	intermediate	
S1PR4	intermediate	
CCR7	intermediate	
C3	intermediate	
OPRD1	intermediate	
GNAI1	intermediate	
GNAT3	intermediate	
GPR55	intermediate	
S1PR5	intermediate	
TAS2R20	intermediate	
CCL21	intermediate	
C5	intermediate	
P2RY4	intermediate	
NPBWR1	intermediate	
CCR8	intermediate	
TAS2R10	intermediate	
CXCL6	intermediate	
GALR2	intermediate	
TAS2R42	intermediate	
ACKR3	intermediate	
C3AR1	intermediate	
CXCR3	intermediate	
TAS2R14	intermediate	
OXGR1	intermediate	
GABBR2	intermediate	
TAS2R9	intermediate	
P2RY14	intermediate	
TAS2R1	intermediate	
FPR3	intermediate	
TAS2R8	intermediate	
PENK	intermediate	
TAS2R43	intermediate	
PDYN	intermediate	
AGTR2	intermediate	
PTGER3	intermediate	
TAS2R19	intermediate	
CXCL5	intermediate	
CXCL1	intermediate	
RXFP4	intermediate	
CORT	intermediate	
CXCR1	intermediate	
GNAI3	intermediate	
OXER1	intermediate	
RXFP3	intermediate	
NPY2R	intermediate	
HTR1F	intermediate	
CXCL13	intermediate	
OPRL1	intermediate	
APLN	intermediate	
CCL19	intermediate	
HCAR3	intermediate	
CCR6	intermediate	
SST	intermediate	
TAS2R38	intermediate	
GRM8	intermediate	
SUCNR1	intermediate	
TAS2R39	intermediate	
PTGDR2	intermediate	
APLNR	intermediate	
TAS2R41	intermediate	
NPY5R	intermediate	
CCL27	intermediate	
TAS2R3	intermediate	
CCL5	intermediate	
PYY	intermediate	
CCR2	intermediate	
S1PR2	intermediate	
CCR4	intermediate	
GPR18	intermediate	
GAL	intermediate	
MCHR2	intermediate	
CCR1	intermediate	
CXCL12	intermediate	
HCAR1	intermediate	
GRM2	intermediate	
NPY	intermediate	
CCR9	intermediate	
PNOC	intermediate	
TAS2R31	intermediate	
CCL25	intermediate	
TAS2R45	intermediate	
CXCL9	intermediate	
MTNR1A	intermediate	
TAS2R16	intermediate	
SSTR4	intermediate	
CXCR6	intermediate	
PPY	intermediate	
INSL5	intermediate	
C5AR1	intermediate	
SSTR3	intermediate	
ANXA1	intermediate	
CXCR2	intermediate	
GRM4	intermediate	
NPB	intermediate	
NPY1R	intermediate	
CXCR4	intermediate	
TAS2R5	intermediate	
P2RY13	intermediate	
GALR3	intermediate	
GPER1	intermediate	
FPR2	intermediate	
NPBWR2	intermediate	
GRM6	intermediate	
MT-RNR2	intermediate	
S1PR3	intermediate	
GALR1	intermediate	
OPRK1	intermediate	
MTNR1B	intermediate	
TAS2R30	intermediate	
GNAI2	intermediate	
CCL20	intermediate	
ADCY3	intermediate	
ADCY1	intermediate	
ADCY4	intermediate	
ADCY7	intermediate	
ADCY5	intermediate	
ADCY8	intermediate	
ADCY6	intermediate	
ADCY9	intermediate	
PLAU	intermediate	
CAV1	intermediate	
