Pseudoephedrine	drug	
TNF	drug_target	
CYP2D6	drug_target	
MAOA	drug_target	
SLC6A4	drug_target	
SLC6A3	drug_target	
SLC6A2	drug_target	
ADRB1	drug_target	
ADRB2	drug_target	
ADRA1A	drug_target	
ADRA2A	drug_target	
NFATC1	drug_target	
IL2	drug_target	
Gastric ulcer	phenotype	
Ropinirole	drug	
CYP1A2	drug_target	
CYP3A4	drug_target	
DRD2	drug_target	
HTR2C	drug_target	
HTR1D	drug_target	
HTR1B	drug_target	
HTR1A	drug_target	
HTR2B	drug_target	
HTR2A	drug_target	
DRD1	drug_target	
DRD5	drug_target	
DRD3	drug_target	
DRD4	drug_target	
ADRA2B	drug_target	
ADRA2C	drug_target	
Donepezil	drug	
CYP2C9	drug_target	
ACHE	drug_target	
Citalopram	drug	
ABCB1	drug_target	
CYP2E1	drug_target	
CYP2C19	drug_target	
CYP2B6	drug_target	
CHRM1	drug_target	
HRH1	drug_target	
Paroxetine	drug	
CYP2C8	drug_target	
CHRM3	drug_target	
CHRM2	drug_target	
CHRM4	drug_target	
CHRM5	drug_target	
Lidocaine	drug	
EGFR	drug_target	
CYP2C18	drug_target	
CYP3A5	drug_target	
SLC22A5	drug_target	
CYP2A6	drug_target	
SCN5A	drug_target	
SCN10A	drug_target	
Clozapine	drug	
CYP1B1	drug_target	
CYP1A1	drug_target	
UGT1A4	drug_target	
ADRA1B	drug_target	
HTR1E	drug_target	
HTR7	drug_target	
HTR3A	drug_target	
HTR6	drug_target	
FMO3	drug_target	
HRH4	drug_target	
CALY	drug_target	
Clomipramine	drug	
ALB	drug_target	
GSTP1	drug_target	
Pramipexole	drug	
SLC22A2	drug_target	
SLC22A1	drug_target	
Cevimeline	drug	
FMO1	drug_target	
Caffeine	drug	
PDE4B	drug_target	
ADORA1	drug_target	
ADORA2A	drug_target	
RYR1	drug_target	
PRKDC	drug_target	
PIK3CD	drug_target	
PIK3CA	drug_target	
PIK3CB	drug_target	
ATM	drug_target	
Metoprolol	drug	
Ibuprofen	drug	
PTGS2	drug_target	
PLAT	drug_target	
PTGS1	drug_target	
THBD	drug_target	
UGT1A9	drug_target	
ABCC1	drug_target	
SLCO1A2	drug_target	
SLC22A6	drug_target	
SLC22A8	drug_target	
ABCC4	drug_target	
PPARG	drug_target	
SLC22A11	drug_target	
UGT1A1	drug_target	
SLCO2B1	drug_target	
UGT1A3	drug_target	
UGT2B7	drug_target	
UGT2B4	drug_target	
FABP2	drug_target	
CFTR	drug_target	
BCL2	drug_target	
Nilotinib	drug	
ABCG2	drug_target	
ABL1	drug_target	
KIT	drug_target	
Hyoscyamine	drug	
Cabergoline	drug	
ADRA1D	drug_target	
Imatinib	drug	
PDGFRB	drug_target	
PDGFRA	drug_target	
ORM1	drug_target	
NTRK1	drug_target	
CSF1R	drug_target	
DDR1	drug_target	
ABCA3	drug_target	
Acamprosate	drug	
GRM5	drug_target	
Phenylephrine	drug	
Diphenhydramine	drug	
Meloxicam	drug	
PGD	drug_target	
Nabumetone	drug	
MPO	drug_target	
Atropine	drug	
Doxylamine	drug	
Scopolamine	drug	
SI	drug_target	
Thalidomide	drug	
FGFR2	drug_target	
CRBN	drug_target	
NFKB1	drug_target	
PMCH	intermediate	
IAPP	intermediate	
BDKRB2	intermediate	
P2RY11	intermediate	
EDN1	intermediate	
CCK	intermediate	
APP	intermediate	
rs1800629	intermediate	
GNG2	intermediate	
ADRB3	intermediate	
GNB1	intermediate	
EGF	intermediate	
BDKRB1	intermediate	
GCGR	intermediate	
LTA	intermediate	
GHRL	intermediate	
SOS1	intermediate	
NPSR1	intermediate	
OXT	intermediate	
OXTR	intermediate	
CCL23	intermediate	
NPS	intermediate	
RLN3	intermediate	
GCG	intermediate	
ADM	intermediate	
GAST	intermediate	
SAA1	intermediate	
GRB2	intermediate	
POMC	intermediate	
NMUR1	intermediate	
LPAR1	intermediate	
CASR	intermediate	
GPR17	intermediate	
NMU	intermediate	
CXCL8	intermediate	
KNG1	intermediate	
NMUR2	intermediate	
AGT	intermediate	
LPAR2	intermediate	
SST	intermediate	
HRH3	intermediate	
NMS	intermediate	
LPAR5	intermediate	
LPAR3	intermediate	
TAS2R40	intermediate	
CCR6	intermediate	
CCR3	intermediate	
CCR5	intermediate	
HTR1F	intermediate	
TAS2R20	intermediate	
S1PR1	intermediate	
NPBWR1	intermediate	
NPY4R	intermediate	
GABBR2	intermediate	
TAS2R16	intermediate	
TAS2R60	intermediate	
CCL21	intermediate	
FPR2	intermediate	
GPR55	intermediate	
FPR1	intermediate	
GRM2	intermediate	
NPB	intermediate	
HEBP1	intermediate	
PDYN	intermediate	
CXCR4	intermediate	
CCL5	intermediate	
C3	intermediate	
CCL16	intermediate	
HTR5A	intermediate	
OPRK1	intermediate	
TAS2R43	intermediate	
GRM8	intermediate	
TAS2R7	intermediate	
TAS2R4	intermediate	
CCR1	intermediate	
SUCNR1	intermediate	
TAS2R8	intermediate	
S1PR2	intermediate	
PPY	intermediate	
SSTR5	intermediate	
CXCL5	intermediate	
RXFP4	intermediate	
CXCR1	intermediate	
S1PR5	intermediate	
TAS2R41	intermediate	
PPBP	intermediate	
C5	intermediate	
PF4	intermediate	
GPR18	intermediate	
CXCL3	intermediate	
TAS2R45	intermediate	
CXCL11	intermediate	
TAS2R46	intermediate	
CXCR3	intermediate	
CXCL6	intermediate	
SSTR4	intermediate	
TAS2R50	intermediate	
NPY2R	intermediate	
CNR2	intermediate	
CXCR2	intermediate	
CXCR5	intermediate	
P2RY13	intermediate	
CXCL13	intermediate	
GRM6	intermediate	
CCL28	intermediate	
CCR2	intermediate	
C5AR1	intermediate	
INSL5	intermediate	
ADORA3	intermediate	
GRM4	intermediate	
MT-RNR2	intermediate	
CXCL16	intermediate	
OPRL1	intermediate	
APLNR	intermediate	
TAS2R9	intermediate	
NPBWR2	intermediate	
P2RY4	intermediate	
CCR7	intermediate	
MCHR1	intermediate	
GNAI1	intermediate	
HCAR2	intermediate	
HCAR3	intermediate	
GALR3	intermediate	
TAS2R31	intermediate	
TAS2R19	intermediate	
CXCL9	intermediate	
FPR3	intermediate	
ANXA1	intermediate	
GNAT3	intermediate	
NPY1R	intermediate	
GNAI3	intermediate	
AGTR2	intermediate	
S1PR4	intermediate	
PNOC	intermediate	
CXCL10	intermediate	
TAS2R3	intermediate	
TAS2R1	intermediate	
TAS2R14	intermediate	
MCHR2	intermediate	
TAS2R10	intermediate	
NPY	intermediate	
PTGER3	intermediate	
CCR10	intermediate	
OXER1	intermediate	
PENK	intermediate	
CXCL1	intermediate	
GALR2	intermediate	
P2RY12	intermediate	
CXCR6	intermediate	
CCR8	intermediate	
GAL	intermediate	
NPY5R	intermediate	
C3AR1	intermediate	
S1PR3	intermediate	
SSTR1	intermediate	
CORT	intermediate	
TAS2R39	intermediate	
SSTR3	intermediate	
CCL20	intermediate	
SSTR2	intermediate	
TAS2R38	intermediate	
GALR1	intermediate	
CXCL2	intermediate	
PYY	intermediate	
MTNR1B	intermediate	
OXGR1	intermediate	
ACKR3	intermediate	
TAS2R5	intermediate	
HCAR1	intermediate	
TAS2R30	intermediate	
CXCL12	intermediate	
P2RY14	intermediate	
PTGDR2	intermediate	
RXFP3	intermediate	
MTNR1A	intermediate	
GPER1	intermediate	
APLN	intermediate	
OPRD1	intermediate	
GNAI2	intermediate	
GRM7	intermediate	
GABBR1	intermediate	
TAS2R42	intermediate	
CCR4	intermediate	
CCL27	intermediate	
CCR9	intermediate	
CCL25	intermediate	
NPW	intermediate	
CCL19	intermediate	
CNR1	intermediate	
TEK	intermediate	
NRG1	intermediate	
PDGFA	intermediate	
FGF2	intermediate	
HGF	intermediate	
MET	intermediate	
FGFR1	intermediate	
ANGPT1	intermediate	
complex:lAo9+jzjVOaRJSWZQvoh0G1mUDc	intermediate	
FN1	intermediate	
TP53	intermediate	
DERL1	intermediate	
RAMP3	intermediate	
PTGDR	intermediate	
LHCGR	intermediate	
SCT	intermediate	
GPR32	intermediate	
GPR84	intermediate	
VIP	intermediate	
VIPR1	intermediate	
RXFP1	intermediate	
HRH2	intermediate	
GPR83	intermediate	
CALCB	intermediate	
TAAR1	intermediate	
RLN2	intermediate	
PTH	intermediate	
TSHB	intermediate	
PTHLH	intermediate	
ADCYAP1R1	intermediate	
GPR45	intermediate	
PTH2R	intermediate	
CALCA	intermediate	
RAMP2	intermediate	
RXFP2	intermediate	
GHRHR	intermediate	
GPR20	intermediate	
GPBAR1	intermediate	
LHB	intermediate	
ADM2	intermediate	
PTGER4	intermediate	
GHRH	intermediate	
GIP	intermediate	
MC1R	intermediate	
GPR150	intermediate	
PTH2	intermediate	
VIPR2	intermediate	
CRHR1	intermediate	
GLP2R	intermediate	
CALCR	intermediate	
GPHA2	intermediate	
PTH1R	intermediate	
GPR176	intermediate	
PTGIR	intermediate	
MC3R	intermediate	
MC2R	intermediate	
CRH	intermediate	
ADORA2B	intermediate	
CGA	intermediate	
CALCRL	intermediate	
HTR4	intermediate	
GIPR	intermediate	
MC5R	intermediate	
ADCYAP1	intermediate	
INSL3	intermediate	
GNAS	intermediate	
RAMP1	intermediate	
SCTR	intermediate	
GPR27	intermediate	
GPR25	intermediate	
FSHR	intermediate	
FSHB	intermediate	
TSHR	intermediate	
GPR15	intermediate	
PTGER2	intermediate	
GPHB5	intermediate	
FGF16	intermediate	
HRAS	intermediate	
FGF8	intermediate	
HBEGF	intermediate	
ERBB2	intermediate	
FGF23	intermediate	
ERBB4	intermediate	
SHC1	intermediate	
KLB	intermediate	
FGF18	intermediate	
NRG4	intermediate	
FGF4	intermediate	
FGFR4	intermediate	
FGFR3	intermediate	
FGF9	intermediate	
FGF17	intermediate	
FGF7	intermediate	
GRB7	intermediate	
FGF22	intermediate	
FGF5	intermediate	
PTPN11	intermediate	
FRS2	intermediate	
CRKL	intermediate	
EREG	intermediate	
PIK3R2	intermediate	
FGF19	intermediate	
FGF3	intermediate	
FGF1	intermediate	
PIK3R1	intermediate	
FGF20	intermediate	
FGF10	intermediate	
KL	intermediate	
CRK	intermediate	
BTC	intermediate	
FGF6	intermediate	
