Tiopronin	drug	
MPO	drug_target	
Subarachnoid hemorrhage	phenotype	
Tirofiban	drug	
ITGB3	drug_target	
ITGA2B	drug_target	
Brain Hemorrhage, Traumatic	phenotype	
Oxaprozin	drug	
PTGS2	drug_target	
PTGS1	drug_target	
CYP2C9	drug_target	
Peptic Ulcer Hemorrhage	phenotype	
Auranofin	drug	
ALB	drug_target	
IKBKB	drug_target	
PRDX5	drug_target	
Cerebral Hemorrhage	phenotype	
Leuprolide	drug	
GNRHR	drug_target	
Internal hemorrhage	phenotype	
Naproxen	drug	
CYP1A2	drug_target	
CYP2C8	drug_target	
SLCO1A2	drug_target	
SLC22A6	drug_target	
UGT1A1	drug_target	
UGT2B7	drug_target	
Cephalexin	drug	
CYP2D6	drug_target	
CYP3A4	drug_target	
SLC22A5	drug_target	
SLC22A8	drug_target	
SLC15A2	drug_target	
SLC47A1	drug_target	
Reteplase	drug	
PLG	drug_target	
FGA	drug_target	
PLAUR	drug_target	
SERPINE1	drug_target	
Gastrointestinal hemorrhage	phenotype	
Tacrolimus	drug	
ABCB1	drug_target	
CYP3A5	drug_target	
ORM1	drug_target	
FKBP1A	drug_target	
ABCA5	drug_target	
Intracranial hemorrhage	phenotype	
Abciximab	drug	
FCGR3B	drug_target	
C1R	drug_target	
C1QA	drug_target	
C1QB	drug_target	
C1QC	drug_target	
FCGR3A	drug_target	
C1S	drug_target	
FCGR1A	drug_target	
FCGR2A	drug_target	
FCGR2B	drug_target	
FCGR2C	drug_target	
VTN	drug_target	
Certolizumab pegol	drug	
TNF	drug_target	
Prasugrel	drug	
CYP2C19	drug_target	
CYP2B6	drug_target	
P2RY12	drug_target	
Subcutaneous hemorrhage	phenotype	
Alteplase	drug	
Quinine	drug	
CYP2E1	drug_target	
SLC22A2	drug_target	
SLC22A1	drug_target	
SLC22A4	drug_target	
CYP1A1	drug_target	
KCNN4	drug_target	
GP9	drug_target	
Piroxicam	drug	
SLC22A11	drug_target	
Edoxaban	drug	
F10	drug_target	
Bismuth Subsalicylate	drug	
TF	drug_target	
Ceftriaxone	drug	
GLUL	drug_target	
Vancomycin	drug	
Glucosamine	drug	
MMP9	drug_target	
IFNG	drug_target	
NFKB2	drug_target	
Tenecteplase	drug	
SERPINB2	drug_target	
CALR	drug_target	
CANX	drug_target	
LRP1	drug_target	
CLEC3B	drug_target	
KRT8	drug_target	
ANXA2	drug_target	
Tolmetin	drug	
TDO2	drug_target	
Eptifibatide	drug	
Bivalirudin	drug	
F2	drug_target	
Cefotetan	drug	
Propylthiouracil	drug	
DBH	drug_target	
TPO	drug_target	
Obinutuzumab	drug	
MS4A1	drug_target	
Nabumetone	drug	
Ampicillin	drug	
SLC16A1	drug_target	
TEK	drug_target	
Enoxaparin	drug	
SERPINC1	drug_target	
Sevoflurane	drug	
GRIA1	drug_target	
GLRA1	drug_target	
MT-ND1	drug_target	
CYP2A6	drug_target	
KCNA1	drug_target	
ATP2C1	drug_target	
ATP5D	drug_target	
GABRA1	drug_target	
Ipilimumab	drug	
CTLA4	drug_target	
Goserelin	drug	
LHCGR	drug_target	
Dasatinib	drug	
ABCG2	drug_target	
PDGFRB	drug_target	
CYP1B1	drug_target	
ABL2	drug_target	
ABL1	drug_target	
FMO3	drug_target	
KIT	drug_target	
SRC	drug_target	
EPHA2	drug_target	
LCK	drug_target	
YES1	drug_target	
STAT5B	drug_target	
FYN	drug_target	
Nilotinib	drug	
Tetracycline	drug	
PADI4	drug_target	
PRNP	drug_target	
Triptorelin	drug	
Cabozantinib	drug	
KDR	drug_target	
RET	drug_target	
MET	drug_target	
Rivaroxaban	drug	
CYP2J2	drug_target	
Olanzapine	drug	
DRD2	drug_target	
CHRM3	drug_target	
CHRM1	drug_target	
HTR2C	drug_target	
CHRM2	drug_target	
ADRA1A	drug_target	
ADRA1B	drug_target	
HRH1	drug_target	
HTR1D	drug_target	
HTR1B	drug_target	
HTR1A	drug_target	
HTR1E	drug_target	
HTR2B	drug_target	
HTR7	drug_target	
HTR2A	drug_target	
DRD1	drug_target	
DRD5	drug_target	
DRD3	drug_target	
DRD4	drug_target	
HTR3A	drug_target	
HTR6	drug_target	
ADRA2A	drug_target	
ADRA2B	drug_target	
ADRA2C	drug_target	
CHRM4	drug_target	
CHRM5	drug_target	
HRH2	drug_target	
HRH4	drug_target	
HTR5A	drug_target	
Fosphenytoin	drug	
SCN5A	drug_target	
Hyaluronidase	drug	
TGFB1	drug_target	
Fenoprofen	drug	
Heparin	drug	
SELP	drug_target	
HPSE	drug_target	
Methyltestosterone	drug	
CYP19A1	drug_target	
AR	drug_target	
SHBG	drug_target	
Epinephrine	drug	
PAH	drug_target	
ADRB1	drug_target	
ADRB2	drug_target	
ADRA1D	drug_target	
ADRB3	drug_target	
Methotrexate	drug	
ABCC2	drug_target	
ABCC3	drug_target	
ABCC1	drug_target	
ABCC10	drug_target	
SLCO1B1	drug_target	
MTHFR	drug_target	
ATIC	drug_target	
FPGS	drug_target	
ABCC4	drug_target	
DHFR	drug_target	
AOX1	drug_target	
GGH	drug_target	
ABCC11	drug_target	
SLC46A1	drug_target	
SLCO1B3	drug_target	
SLCO1C1	drug_target	
SLCO3A1	drug_target	
TYMS	drug_target	
PGD	drug_target	
SLC19A1	drug_target	
FOLR1	drug_target	
Nintedanib	drug	
FGFR2	drug_target	
FGFR1	drug_target	
FGFR3	drug_target	
FLT4	drug_target	
FLT3	drug_target	
FLT1	drug_target	
LYN	drug_target	
Fondaparinux sodium	drug	
Clonazepam	drug	
TSPO	drug_target	
NAT2	drug_target	
Rilonacept	drug	
IL1B	drug_target	
IL1A	drug_target	
IL1RN	drug_target	
Bromfenac	drug	
Vandetanib	drug	
EGFR	drug_target	
VEGFA	drug_target	
FMO1	drug_target	
PTK6	drug_target	
Flurbiprofen	drug	
UGT1A9	drug_target	
UGT1A3	drug_target	
UGT2B4	drug_target	
Dabigatran etexilate	drug	
NQO2	drug_target	
UGT2B15	drug_target	
CES1	drug_target	
Desflurane	drug	
Acitretin	drug	
RBP1	drug_target	
CYP26A1	drug_target	
RARG	drug_target	
RARB	drug_target	
RXRG	drug_target	
RXRB	drug_target	
RARA	drug_target	
RXRA	drug_target	
Prednisone	drug	
HSD11B1	drug_target	
NR3C1	drug_target	
Pentoxifylline	drug	
PDE4B	drug_target	
ADORA1	drug_target	
ADORA2A	drug_target	
PDE5A	drug_target	
PDE4A	drug_target	
NT5E	drug_target	
Risperidone	drug	
Quetiapine	drug	
Thalidomide	drug	
CRBN	drug_target	
NFKB1	drug_target	
Ponatinib	drug	
FGFR4	drug_target	
ABCB11	drug_target	
PDGFRA	drug_target	
BCR	drug_target	
Olsalazine	drug	
TPMT	drug_target	
Pazopanib	drug	
FGF1	drug_target	
ITK	drug_target	
SH2B3	drug_target	
Meclofenamic acid	drug	
ALOX5	drug_target	
KCNQ2	drug_target	
KCNQ3	drug_target	
Velaglucerase alfa	drug	
GBA	drug_target	
Aprotinin	drug	
PRSS1	drug_target	
KLK1	drug_target	
Oxymetholone	drug	
MAOA	drug_target	
SRD5A1	drug_target	
NPPB	drug_target	
Diflunisal	drug	
UGT1A8	drug_target	
TTR	drug_target	
Salicylic acid	drug	
AKR1C1	drug_target	
SLCO2B1	drug_target	
Ketoprofen	drug	
CXCR1	drug_target	
Meloxicam	drug	
Mefenamic acid	drug	
Carvedilol	drug	
XDH	drug_target	
NDUFC2	drug_target	
KCNH2	drug_target	
VCAM1	drug_target	
GJA1	drug_target	
SELE	drug_target	
HIF1A	drug_target	
Dalteparin	drug	
TFPI	drug_target	
Phenylephrine	drug	
Cefazolin	drug	
PON1	drug_target	
Regorafenib	drug	
NTRK1	drug_target	
BRAF	drug_target	
RAF1	drug_target	
MAPK11	drug_target	
DDR2	drug_target	
FRK	drug_target	
Lauric Acid	drug	
ADH5	drug_target	
PLA2G2A	drug_target	
TLR4	drug_target	
LTF	drug_target	
GM2A	drug_target	
LY96	drug_target	
HNF4A	drug_target	
VLDLR	drug_target	
GLTP	drug_target	
C8G	drug_target	
PLA2G2D	drug_target	
Lidocaine	drug	
CYP2C18	drug_target	
SCN10A	drug_target	
Aripiprazole	drug	
Ramucirumab	drug	
Sorafenib	drug	
RALBP1	drug_target	
Nafarelin	drug	
Etanercept	drug	
TNFRSF1B	drug_target	
LTA	drug_target	
Cefotaxime	drug	
Infliximab	drug	
Acamprosate	drug	
GRM5	drug_target	
Diazoxide	drug	
KCNJ11	drug_target	
CA1	drug_target	
CA2	drug_target	
KCNMA1	drug_target	
ATP1A1	drug_target	
SLC12A3	drug_target	
Iloprost	drug	
PLAT	drug_target	
PDE4D	drug_target	
PTGER1	drug_target	
PTGIR	drug_target	
PDE4C	drug_target	
TP53	intermediate	
F7	intermediate	
RELA	intermediate	
FN1	intermediate	
CST3	intermediate	
APOE	intermediate	
NFKBIA	intermediate	
CAMTA1	intermediate	
complex:lAo9+jzjVOaRJSWZQvoh0G1mUDc	intermediate	
IRAK1	intermediate	
CHUK	intermediate	
APP	intermediate	
GNAQ	intermediate	
CYSLTR2	intermediate	
GNA11	intermediate	
ITGA2	intermediate	
APOA1	intermediate	
FGB	intermediate	
FGG	intermediate	
VWF	intermediate	
TGFBR1	intermediate	
SLA2	intermediate	
HP	intermediate	
GFAP	intermediate	
TGFBR2	intermediate	
PLAU	intermediate	
rs1800629	intermediate	
PPBP	intermediate	
GABBR1	intermediate	
CXCL1	intermediate	
AGT	intermediate	
CCL20	intermediate	
CXCL12	intermediate	
GP1BB	intermediate	
F9	intermediate	
BIN1	intermediate	
DNAJC6	intermediate	
JAK2	intermediate	
RELB	intermediate	
F5	intermediate	
EDNRB	intermediate	
TACR1	intermediate	
GCG	intermediate	
GCGR	intermediate	
EDN1	intermediate	
VIPR2	intermediate	
NPSR1	intermediate	
RXFP1	intermediate	
GNB1	intermediate	
NPS	intermediate	
P2RY11	intermediate	
CALCA	intermediate	
GNG2	intermediate	
KRT14	intermediate	
CDC42	intermediate	
SHC1	intermediate	
FGF4	intermediate	
PIK3R1	intermediate	
NRG1	intermediate	
KLB	intermediate	
FGF6	intermediate	
FRS2	intermediate	
FGF19	intermediate	
SLIT2	intermediate	
SPTBN4	intermediate	
HRAS	intermediate	
BTC	intermediate	
PECAM1	intermediate	
PRKCQ	intermediate	
PIK3CA	intermediate	
NCK1	intermediate	
FGF9	intermediate	
FGF20	intermediate	
PIK3R2	intermediate	
FGF2	intermediate	
FGF16	intermediate	
FGF3	intermediate	
ERBB2	intermediate	
PTPN11	intermediate	
ERBB4	intermediate	
FGF22	intermediate	
HBEGF	intermediate	
FGF7	intermediate	
FGF8	intermediate	
GRB2	intermediate	
NRG4	intermediate	
FGF5	intermediate	
FGF23	intermediate	
FGF17	intermediate	
FGF10	intermediate	
KITLG	intermediate	
SOS1	intermediate	
PIK3CB	intermediate	
FGF18	intermediate	
EREG	intermediate	
SPTBN5	intermediate	
KL	intermediate	
DOCK1	intermediate	
KRAS	intermediate	
CRK	intermediate	
PTK2	intermediate	
CSF2	intermediate	
TAS2R50	intermediate	
CXCL10	intermediate	
CNR1	intermediate	
CCL16	intermediate	
MCHR1	intermediate	
TAS2R46	intermediate	
CXCL3	intermediate	
TAS2R40	intermediate	
CXCL11	intermediate	
RLN3	intermediate	
CNR2	intermediate	
GRM7	intermediate	
CXCR5	intermediate	
LPAR3	intermediate	
ADORA3	intermediate	
POMC	intermediate	
S1PR1	intermediate	
HRH3	intermediate	
CCR10	intermediate	
HEBP1	intermediate	
NPW	intermediate	
CCL28	intermediate	
NPY4R	intermediate	
TAS2R4	intermediate	
CXCL16	intermediate	
HCAR2	intermediate	
PMCH	intermediate	
PF4	intermediate	
TAS2R60	intermediate	
TAS2R7	intermediate	
CCR3	intermediate	
S1PR4	intermediate	
CCR7	intermediate	
C3	intermediate	
OPRD1	intermediate	
MGST2	intermediate	
GNAI1	intermediate	
CXCL8	intermediate	
SSTR2	intermediate	
GNAT3	intermediate	
MGST3	intermediate	
GPR55	intermediate	
TAS2R20	intermediate	
S1PR5	intermediate	
CCL21	intermediate	
C5	intermediate	
P2RY4	intermediate	
NPBWR1	intermediate	
SSTR1	intermediate	
CCR8	intermediate	
TAS2R10	intermediate	
CXCL6	intermediate	
GALR2	intermediate	
TAS2R42	intermediate	
ACKR3	intermediate	
C3AR1	intermediate	
CXCR3	intermediate	
NMUR1	intermediate	
TAS2R14	intermediate	
OXGR1	intermediate	
GABBR2	intermediate	
TAS2R9	intermediate	
P2RY14	intermediate	
FPR3	intermediate	
TAS2R1	intermediate	
TAS2R43	intermediate	
PENK	intermediate	
TAS2R8	intermediate	
PDYN	intermediate	
AGTR2	intermediate	
MGST1	intermediate	
CCR5	intermediate	
LPAR1	intermediate	
PTGER3	intermediate	
TAS2R19	intermediate	
CXCL5	intermediate	
RXFP4	intermediate	
CORT	intermediate	
CXCL2	intermediate	
GNAI3	intermediate	
OXER1	intermediate	
RXFP3	intermediate	
HTR1F	intermediate	
NPY2R	intermediate	
CXCL13	intermediate	
OPRL1	intermediate	
APLN	intermediate	
CCL19	intermediate	
HCAR3	intermediate	
CCR6	intermediate	
SST	intermediate	
TAS2R38	intermediate	
KNG1	intermediate	
GRM8	intermediate	
SUCNR1	intermediate	
TAS2R39	intermediate	
PTGDR2	intermediate	
APLNR	intermediate	
SAA1	intermediate	
TAS2R41	intermediate	
CCL27	intermediate	
NPY5R	intermediate	
TAS2R3	intermediate	
CCL5	intermediate	
NMU	intermediate	
NMUR2	intermediate	
PYY	intermediate	
CCR2	intermediate	
S1PR2	intermediate	
CCR4	intermediate	
CASR	intermediate	
SSTR5	intermediate	
GPR18	intermediate	
FPR1	intermediate	
GAL	intermediate	
MCHR2	intermediate	
CCR1	intermediate	
HCAR1	intermediate	
GRM2	intermediate	
NMS	intermediate	
NPY	intermediate	
CCR9	intermediate	
TAS2R45	intermediate	
LPAR5	intermediate	
CCL25	intermediate	
PNOC	intermediate	
TAS2R31	intermediate	
CXCL9	intermediate	
TAS2R13	intermediate	
GPR17	intermediate	
MTNR1A	intermediate	
TAS2R16	intermediate	
SSTR4	intermediate	
CXCR6	intermediate	
PPY	intermediate	
INSL5	intermediate	
C5AR1	intermediate	
SSTR3	intermediate	
ANXA1	intermediate	
CXCR2	intermediate	
GRM4	intermediate	
NPB	intermediate	
NPY1R	intermediate	
CCL23	intermediate	
TAS2R5	intermediate	
BDKRB1	intermediate	
CXCR4	intermediate	
P2RY13	intermediate	
LPAR2	intermediate	
GALR3	intermediate	
GPER1	intermediate	
FPR2	intermediate	
NPBWR2	intermediate	
GRM6	intermediate	
MT-RNR2	intermediate	
S1PR3	intermediate	
GALR1	intermediate	
BDKRB2	intermediate	
OPRK1	intermediate	
MTNR1B	intermediate	
TAS2R30	intermediate	
GNAI2	intermediate	
SMAD3	intermediate	
TSHR	intermediate	
GPR27	intermediate	
GIP	intermediate	
CRHR1	intermediate	
RAMP1	intermediate	
PTH	intermediate	
CRH	intermediate	
ADM	intermediate	
PTHLH	intermediate	
TAAR1	intermediate	
GHRH	intermediate	
GPR32	intermediate	
MC2R	intermediate	
GHRHR	intermediate	
GPR83	intermediate	
VIP	intermediate	
FSHR	intermediate	
LHB	intermediate	
PTH1R	intermediate	
PTGDR	intermediate	
PTGER4	intermediate	
PTGER2	intermediate	
GPR150	intermediate	
GPBAR1	intermediate	
SCT	intermediate	
TSHB	intermediate	
ADM2	intermediate	
RAMP3	intermediate	
VIPR1	intermediate	
GPHB5	intermediate	
GIPR	intermediate	
ADCYAP1	intermediate	
IAPP	intermediate	
CGA	intermediate	
ADORA2B	intermediate	
RAMP2	intermediate	
MC1R	intermediate	
PTH2	intermediate	
GPR84	intermediate	
HTR4	intermediate	
GPHA2	intermediate	
GPR45	intermediate	
GLP2R	intermediate	
INSL3	intermediate	
PTH2R	intermediate	
CALCRL	intermediate	
MC3R	intermediate	
GNAS	intermediate	
ADCYAP1R1	intermediate	
RLN2	intermediate	
CALCR	intermediate	
FSHB	intermediate	
GPR176	intermediate	
GPR20	intermediate	
MC5R	intermediate	
RXFP2	intermediate	
CALCB	intermediate	
SCTR	intermediate	
GPR25	intermediate	
GPR15	intermediate	
HLA-DRB1	intermediate	
PDGFB	intermediate	
HLA-DPB1	intermediate	
PLCG1	intermediate	
HGF	intermediate	
B2M	intermediate	
PTPN22	intermediate	
PDGFA	intermediate	
IL1RAP	intermediate	
MYD88	intermediate	
IL1R1	intermediate	
IRAK4	intermediate	
LAT	intermediate	
DNM2	intermediate	
HSP90AA1	intermediate	
FZD4	intermediate	
CRABP2	intermediate	
NCOA3	intermediate	
ADCY3	intermediate	
ADCY1	intermediate	
ADCY4	intermediate	
ADCY7	intermediate	
ADCY5	intermediate	
ADCY8	intermediate	
ADCY6	intermediate	
ADCY9	intermediate	
KRT5	intermediate	
GRB7	intermediate	
GAB2	intermediate	
APOB	intermediate	
ITGAV	intermediate	
VAV1	intermediate	
ROCK1	intermediate	
TJP1	intermediate	
UBC	intermediate	
IRS2	intermediate	
RHOA	intermediate	
CRKL	intermediate	
IRS1	intermediate	
NRAS	intermediate	
TLR3	intermediate	
AVP	intermediate	
ANGPT1	intermediate	
TRAF2	intermediate	
MAP3K14	intermediate	
BIRC2	intermediate	
TRAF3	intermediate	
BIRC3	intermediate	
ABCC8	intermediate	
