Desflurane	drug	
ALB	drug_target	
GRIA1	drug_target	
GLRA1	drug_target	
MT-ND1	drug_target	
KCNA1	drug_target	
ATP2C1	drug_target	
ATP5D	drug_target	
Hepatic necrosis	phenotype	
Menthol	drug	
OPRK1	drug_target	
TRPM8	drug_target	
Sevoflurane	drug	
CYP3A4	drug_target	
CYP2E1	drug_target	
CYP2B6	drug_target	
CYP2A6	drug_target	
GABRA1	drug_target	
Hydrocodone	drug	
CYP2D6	drug_target	
OPRM1	drug_target	
OPRD1	drug_target	
NDUFAF2	intermediate	
TGFA	intermediate	
NDUFA2	intermediate	
NDUFS4	intermediate	
NDUFA10	intermediate	
HADH	intermediate	
NDUFA12	intermediate	
CNR2	intermediate	
CXCR2	intermediate	
FPR1	intermediate	
