Menthol	drug	
OPRK1	drug_target	
TRPM8	drug_target	
Hyperlipidemia, combined, 1	phenotype	
Testosterone	drug	
ABCB1	drug_target	
CYP3A4	drug_target	
CYP2C9	drug_target	
ALB	drug_target	
CYP19A1	drug_target	
CYP2C19	drug_target	
CYP3A5	drug_target	
CYP2C8	drug_target	
SLCO1A2	drug_target	
SLC10A1	drug_target	
ABCG2	drug_target	
CYP1B1	drug_target	
SLC22A1	drug_target	
SLC22A3	drug_target	
SLC22A4	drug_target	
SLC22A8	drug_target	
MAOA	drug_target	
CYP1A1	drug_target	
CYP11A1	drug_target	
CYP2B6	drug_target	
CYP2A13	drug_target	
AR	drug_target	
SHBG	drug_target	
CYP3A43	drug_target	
Quetiapine	drug	
CYP2D6	drug_target	
DRD2	drug_target	
CHRM3	drug_target	
CHRM1	drug_target	
HTR2C	drug_target	
CHRM2	drug_target	
ADRA1A	drug_target	
ADRA1B	drug_target	
ADRA1D	drug_target	
HRH1	drug_target	
HTR1D	drug_target	
HTR1B	drug_target	
HTR1A	drug_target	
HTR1E	drug_target	
HTR7	drug_target	
HTR2A	drug_target	
DRD1	drug_target	
DRD5	drug_target	
DRD3	drug_target	
DRD4	drug_target	
HTR3A	drug_target	
HTR6	drug_target	
ADRA2A	drug_target	
ADRA2B	drug_target	
ADRA2C	drug_target	
CHRM4	drug_target	
CHRM5	drug_target	
Estradiol	drug	
CYP1A2	drug_target	
ABCC10	drug_target	
SLCO1B1	drug_target	
SLC22A2	drug_target	
NR1I2	drug_target	
SLC22A11	drug_target	
UGT1A1	drug_target	
SLCO2B1	drug_target	
SLCO1B3	drug_target	
SLCO1C1	drug_target	
ESR1	drug_target	
ESR2	drug_target	
SLCO4A1	drug_target	
FABP2	drug_target	
Hyperlipidemia, familial combined	phenotype	
Olanzapine	drug	
HTR2B	drug_target	
FMO3	drug_target	
HRH2	drug_target	
ORM1	drug_target	
HRH4	drug_target	
HTR5A	drug_target	
Betaxolol	drug	
ADRB1	drug_target	
ADRB2	drug_target	
Propofol	drug	
CYP2E1	drug_target	
UGT1A9	drug_target	
CYP2C18	drug_target	
CYP2A6	drug_target	
UGT1A6	drug_target	
UGT1A8	drug_target	
GABRB2	drug_target	
GABRB3	drug_target	
FAAH	drug_target	
SCN2A	drug_target	
SCN4A	drug_target	
Propafenone	drug	
SCN5A	drug_target	
KCNH2	drug_target	
Memantine	drug	
GRIN1	drug_target	
GRIN2A	drug_target	
GRIN2B	drug_target	
GRIN3A	drug_target	
Methotrexate	drug	
ABCC2	drug_target	
ABCC3	drug_target	
ABCC1	drug_target	
SLC22A6	drug_target	
MTHFR	drug_target	
ATIC	drug_target	
SLC16A1	drug_target	
FPGS	drug_target	
ABCC4	drug_target	
DHFR	drug_target	
AOX1	drug_target	
GGH	drug_target	
ABCC11	drug_target	
SLC46A1	drug_target	
SLCO3A1	drug_target	
TYMS	drug_target	
PGD	drug_target	
SLC19A1	drug_target	
FOLR1	drug_target	
Fluoxetine	drug	
SLC6A4	drug_target	
Isotretinoin	drug	
RARA	drug_target	
Warfarin	drug	
VKORC1	drug_target	
Saquinavir	drug	
Ziprasidone	drug	
Valsartan	drug	
AGTR1	drug_target	
Bisoprolol	drug	
Tofacitinib	drug	
JAK2	drug_target	
JAK1	drug_target	
JAK3	drug_target	
Glycine	drug	
AGXT2	drug_target	
SHMT1	drug_target	
GCAT	drug_target	
GLDC	drug_target	
ALAS1	drug_target	
AGXT	drug_target	
SHMT2	drug_target	
ALAS2	drug_target	
SLC16A10	drug_target	
GNMT	drug_target	
GATM	drug_target	
GRIN3B	drug_target	
GRIN2C	drug_target	
GSS	drug_target	
GCSH	drug_target	
GARS	drug_target	
BAAT	drug_target	
GPR18	drug_target	
GLYAT	drug_target	
SLC32A1	drug_target	
PIPOX	drug_target	
SLC6A5	drug_target	
SLC6A9	drug_target	
GLRA1	drug_target	
GLRB	drug_target	
GLRA3	drug_target	
GLRA2	drug_target	
Pramipexole	drug	
Sotalol	drug	
Zidovudine	drug	
ABCC5	drug_target	
UGT2B7	drug_target	
TK1	drug_target	
SLC28A1	drug_target	
SLC29A2	drug_target	
TERT	drug_target	
Gabapentin	drug	
BCAT1	drug_target	
ADORA1	drug_target	
CACNA2D1	drug_target	
CACNA2D2	drug_target	
CACNA1B	drug_target	
Lidocaine	drug	
EGFR	drug_target	
SLC22A5	drug_target	
SCN10A	drug_target	
Aripiprazole	drug	
Tacrolimus	drug	
FKBP1A	drug_target	
ABCA5	drug_target	
Prasugrel	drug	
P2RY12	drug_target	
Arformoterol	drug	
C3	intermediate	
CCR2	intermediate	
CNR1	intermediate	
SAA1	intermediate	
NPY	intermediate	
CCL5	intermediate	
GAL	intermediate	
AGT	intermediate	
AGTR2	intermediate	
CCR7	intermediate	
CCR5	intermediate	
APOA4	intermediate	
F7	intermediate	
APOA2	intermediate	
APOC1	intermediate	
APOC3	intermediate	
APOC2	intermediate	
SLC25A13	intermediate	
APOA1	intermediate	
HP	intermediate	
APOE	intermediate	
CDCP1	intermediate	
NPHS1	intermediate	
complex:lAo9+jzjVOaRJSWZQvoh0G1mUDc	intermediate	
GCG	intermediate	
TAS2R50	intermediate	
CXCL10	intermediate	
CCL16	intermediate	
MCHR1	intermediate	
TAS2R46	intermediate	
CXCL3	intermediate	
CXCL11	intermediate	
TAS2R40	intermediate	
RLN3	intermediate	
CNR2	intermediate	
GRM7	intermediate	
CXCR5	intermediate	
LPAR3	intermediate	
HRH3	intermediate	
GABBR1	intermediate	
POMC	intermediate	
ADORA3	intermediate	
S1PR1	intermediate	
HEBP1	intermediate	
NPW	intermediate	
CCR10	intermediate	
CCL28	intermediate	
NPY4R	intermediate	
TAS2R4	intermediate	
HCAR2	intermediate	
CXCL16	intermediate	
PMCH	intermediate	
PF4	intermediate	
PTH	intermediate	
TAS2R60	intermediate	
PPBP	intermediate	
TAS2R7	intermediate	
CCR3	intermediate	
S1PR4	intermediate	
P2RY11	intermediate	
LDLR	intermediate	
ADM	intermediate	
OPRD1	intermediate	
GNAI1	intermediate	
SSTR2	intermediate	
CXCL8	intermediate	
F2	intermediate	
GNAT3	intermediate	
GPR55	intermediate	
S1PR5	intermediate	
TAS2R20	intermediate	
CCL21	intermediate	
C5	intermediate	
P2RY4	intermediate	
NPBWR1	intermediate	
SSTR1	intermediate	
CCR8	intermediate	
TAS2R10	intermediate	
CXCL6	intermediate	
APOB	intermediate	
GALR2	intermediate	
NPS	intermediate	
TAS2R42	intermediate	
ACKR3	intermediate	
C3AR1	intermediate	
CXCR3	intermediate	
NMUR1	intermediate	
TAS2R14	intermediate	
OXGR1	intermediate	
GABBR2	intermediate	
TAS2R9	intermediate	
FSHR	intermediate	
P2RY14	intermediate	
TAS2R1	intermediate	
FPR3	intermediate	
LDLRAP1	intermediate	
TAS2R8	intermediate	
PENK	intermediate	
PDYN	intermediate	
TAS2R43	intermediate	
LPAR1	intermediate	
PTGER3	intermediate	
TAS2R19	intermediate	
CXCL5	intermediate	
CXCL1	intermediate	
RXFP4	intermediate	
CORT	intermediate	
CXCL2	intermediate	
CXCR1	intermediate	
GNAI3	intermediate	
OXER1	intermediate	
RXFP3	intermediate	
NPY2R	intermediate	
HTR1F	intermediate	
CXCL13	intermediate	
OPRL1	intermediate	
APLN	intermediate	
CCL19	intermediate	
HCAR3	intermediate	
CCR6	intermediate	
TRH	intermediate	
SST	intermediate	
TAS2R38	intermediate	
KNG1	intermediate	
GRM8	intermediate	
SUCNR1	intermediate	
TAS2R39	intermediate	
PTGDR2	intermediate	
APLNR	intermediate	
TAS2R41	intermediate	
NPY5R	intermediate	
CCL27	intermediate	
TAS2R3	intermediate	
NMU	intermediate	
NMUR2	intermediate	
PYY	intermediate	
S1PR2	intermediate	
CCR4	intermediate	
LRP2	intermediate	
CASR	intermediate	
SSTR5	intermediate	
FPR1	intermediate	
MCHR2	intermediate	
CCR1	intermediate	
CXCL12	intermediate	
HCAR1	intermediate	
GRM2	intermediate	
NMS	intermediate	
CCR9	intermediate	
GNG2	intermediate	
PNOC	intermediate	
LPAR5	intermediate	
TAS2R31	intermediate	
CCL25	intermediate	
TAS2R45	intermediate	
CXCL9	intermediate	
MTNR1A	intermediate	
GPR17	intermediate	
TAS2R16	intermediate	
SSTR4	intermediate	
CXCR6	intermediate	
PPY	intermediate	
INSL5	intermediate	
GCGR	intermediate	
C5AR1	intermediate	
SSTR3	intermediate	
ANXA1	intermediate	
CXCR2	intermediate	
GRM4	intermediate	
NPB	intermediate	
NPY1R	intermediate	
CCL23	intermediate	
NPSR1	intermediate	
APP	intermediate	
GNB1	intermediate	
CXCR4	intermediate	
BDKRB1	intermediate	
TAS2R5	intermediate	
P2RY13	intermediate	
LPAR2	intermediate	
GALR3	intermediate	
GPER1	intermediate	
FPR2	intermediate	
NPBWR2	intermediate	
GRM6	intermediate	
MT-RNR2	intermediate	
S1PR3	intermediate	
GALR1	intermediate	
BDKRB2	intermediate	
MTNR1B	intermediate	
ADRB3	intermediate	
TAS2R30	intermediate	
GNAI2	intermediate	
CCL20	intermediate	
FN1	intermediate	
MGST2	intermediate	
MGST3	intermediate	
MGST1	intermediate	
SHC1	intermediate	
TFG	intermediate	
F5	intermediate	
CRABP2	intermediate	
IRS1	intermediate	
GH1	intermediate	
CD59	intermediate	
PTPRA	intermediate	
KL	intermediate	
