Triptorelin	drug	
GNRHR	drug_target	
Pulmonary hypertension, neonatal, susceptibility to	phenotype	
Histamine	drug	
CYP2D6	drug_target	
CYP3A4	drug_target	
CYP2C9	drug_target	
SLC22A2	drug_target	
SLC22A1	drug_target	
SLC22A3	drug_target	
SLC22A5	drug_target	
HRH1	drug_target	
HRH2	drug_target	
HRH4	drug_target	
HRH3	drug_target	
HNMT	drug_target	
Pasireotide	drug	
SSTR1	drug_target	
SSTR5	drug_target	
SSTR2	drug_target	
SSTR3	drug_target	
Ergotamine	drug	
CYP1A2	drug_target	
ABCB1	drug_target	
SLC6A2	drug_target	
DRD2	drug_target	
HTR2C	drug_target	
ADRA1A	drug_target	
ADRA1B	drug_target	
ADRA1D	drug_target	
HTR1D	drug_target	
HTR1B	drug_target	
HTR1F	drug_target	
HTR1A	drug_target	
HTR2A	drug_target	
ADRA2A	drug_target	
ADRA2B	drug_target	
Amantadine	drug	
DDC	drug_target	
GRIN3A	drug_target	
MAOB	drug_target	
Pulmonary arterial hypertension	phenotype	
Ponatinib	drug	
FGFR2	drug_target	
FGFR1	drug_target	
FGFR4	drug_target	
FGFR3	drug_target	
CYP3A5	drug_target	
CYP2C8	drug_target	
ABCB11	drug_target	
ABCG2	drug_target	
PDGFRA	drug_target	
ABL1	drug_target	
KDR	drug_target	
FLT3	drug_target	
KIT	drug_target	
RET	drug_target	
TEK	drug_target	
SRC	drug_target	
LCK	drug_target	
LYN	drug_target	
BCR	drug_target	
Primary pulmonary hypertension	phenotype	
Salsalate	drug	
PTGS2	drug_target	
PTGS1	drug_target	
Renovascular hypertension	phenotype	
Dexamethasone	drug	
CYP2E1	drug_target	
ABCC2	drug_target	
CYP19A1	drug_target	
CYP2C19	drug_target	
CYP4A11	drug_target	
SLCO1A2	drug_target	
CYP1B1	drug_target	
NOS2	drug_target	
CYP17A1	drug_target	
CYP1A1	drug_target	
CYP11A1	drug_target	
CYP2B6	drug_target	
CYP2A6	drug_target	
NR3C1	drug_target	
ANXA1	drug_target	
CYP3A43	drug_target	
NR0B1	drug_target	
Essential hypertension	phenotype	
Ranitidine	drug	
SLC22A8	drug_target	
Cyclobenzaprine	drug	
Zolmitriptan	drug	
MAOA	drug_target	
genetic hypertension	phenotype	
Amitriptyline	drug	
ALB	drug_target	
SLC6A4	drug_target	
CHRM3	drug_target	
CHRM1	drug_target	
OPRM1	drug_target	
OPRK1	drug_target	
OPRD1	drug_target	
CHRM2	drug_target	
HTR7	drug_target	
KCNA1	drug_target	
HTR6	drug_target	
CHRM4	drug_target	
CHRM5	drug_target	
KCND2	drug_target	
KCND3	drug_target	
ORM1	drug_target	
NTRK1	drug_target	
NTRK2	drug_target	
KCNQ2	drug_target	
SIGMAR1	drug_target	
KCNQ3	drug_target	
Escitalopram	drug	
SLC6A3	drug_target	
Succinylcholine	drug	
BCHE	drug_target	
Clozapine	drug	
UGT1A4	drug_target	
HTR1E	drug_target	
DRD1	drug_target	
DRD3	drug_target	
DRD4	drug_target	
HTR3A	drug_target	
ADRA2C	drug_target	
FMO3	drug_target	
CALY	drug_target	
Sufentanil	drug	
Hypertension	phenotype	
Brompheniramine	drug	
Diphenoxylate	drug	
Regadenoson	drug	
ADORA2A	drug_target	
Epinephrine	drug	
TNF	drug_target	
PAH	drug_target	
ADRB1	drug_target	
ADRB2	drug_target	
ADRB3	drug_target	
Testosterone	drug	
SLC10A1	drug_target	
SLC22A4	drug_target	
CYP2A13	drug_target	
AR	drug_target	
SHBG	drug_target	
Hyperuricemia, pulmonary hypertension, renal failure, and alkalosis	phenotype	
Buprenorphine	drug	
UGT1A9	drug_target	
CYP2C18	drug_target	
Paroxetine	drug	
Cabozantinib	drug	
MET	drug_target	
Oxybutynin	drug	
Darifenacin	drug	
Codeine	drug	
UGT2B7	drug_target	
UGT2B4	drug_target	
Rotigotine	drug	
DRD5	drug_target	
Teriparatide	drug	
PTH1R	drug_target	
Diphenhydramine	drug	
Riboflavin	drug	
SLC22A6	drug_target	
MTHFR	drug_target	
RFK	drug_target	
BLVRB	drug_target	
Nabilone	drug	
CNR1	drug_target	
CNR2	drug_target	
Ondansetron	drug	
HTR4	drug_target	
Fluphenazine	drug	
CALM3	drug_target	
Propranolol	drug	
Cabergoline	drug	
HTR2B	drug_target	
Pseudoephedrine	drug	
NFATC1	drug_target	
IL2	drug_target	
Hydrocodone	drug	
Perphenazine	drug	
Triprolidine	drug	
Imipramine	drug	
KCNH2	drug_target	
Naratriptan	drug	
Oxaliplatin	drug	
MPO	drug_target	
GSTM1	drug_target	
GSTP1	drug_target	
GSTT1	drug_target	
NQO1	drug_target	
SOD1	drug_target	
MT1A	drug_target	
MT2A	drug_target	
SLC31A1	drug_target	
ATP7B	drug_target	
ATP7A	drug_target	
Ocular Hypertension	phenotype	
Imatinib	drug	
PDGFRB	drug_target	
CSF1R	drug_target	
DDR1	drug_target	
ABCA3	drug_target	
Lenvatinib	drug	
AOX1	drug_target	
FLT4	drug_target	
FLT1	drug_target	
Droperidol	drug	
Dopamine	drug	
COMT	drug_target	
DBH	drug_target	
POU5F1	drug_target	
Tocilizumab	drug	
IL6R	drug_target	
Tinzaparin	drug	
ITGA4	drug_target	
SERPINC1	drug_target	
CXCL12	drug_target	
ADAMTS4	drug_target	
Etonogestrel	drug	
ESR1	drug_target	
PGR	drug_target	
Pregnancy associated hypertension	phenotype	
Modafinil	drug	
Glycine	drug	
AGXT2	drug_target	
SHMT1	drug_target	
GCAT	drug_target	
GLDC	drug_target	
ALAS1	drug_target	
AGXT	drug_target	
SHMT2	drug_target	
ALAS2	drug_target	
SLC16A10	drug_target	
GNMT	drug_target	
GATM	drug_target	
GRIN3B	drug_target	
GRIN2A	drug_target	
GRIN2C	drug_target	
GSS	drug_target	
GCSH	drug_target	
GARS	drug_target	
BAAT	drug_target	
GPR18	drug_target	
GLYAT	drug_target	
SLC32A1	drug_target	
PIPOX	drug_target	
SLC6A5	drug_target	
SLC6A9	drug_target	
GLRA1	drug_target	
GLRB	drug_target	
GLRA3	drug_target	
GLRA2	drug_target	
Insulin Glargine	drug	
INSR	drug_target	
IGF1R	drug_target	
Carbinoxamine	drug	
Dextroamphetamine	drug	
SLC18A2	drug_target	
TAAR1	drug_target	
Tiotropium	drug	
Maprotiline	drug	
Quetiapine	drug	
Lanreotide	drug	
Nintedanib	drug	
Repaglinide	drug	
SLCO1B1	drug_target	
PPARG	drug_target	
ABCC8	drug_target	
Dextromethorphan	drug	
CHRNA4	drug_target	
CHRNA7	drug_target	
CHRNB2	drug_target	
CHRNA2	drug_target	
CHRNA3	drug_target	
CHRNB4	drug_target	
PGRMC1	drug_target	
Ticagrelor	drug	
P2RY12	drug_target	
Eletriptan	drug	
Adenosine	drug	
ADK	drug_target	
ADA	drug_target	
ADORA1	drug_target	
SLC28A3	drug_target	
ADORA2B	drug_target	
Ziprasidone	drug	
Desipramine	drug	
SMPD1	drug_target	
Butorphanol	drug	
Asenapine	drug	
HTR5A	drug_target	
Portal hypertension, noncirrhotic	phenotype	
Tramadol	drug	
Carboplatin	drug	
XDH	drug_target	
SLC31A2	drug_target	
Lisdexamfetamine	drug	
Haloperidol	drug	
GRIN2B	drug_target	
CBR1	drug_target	
Memantine	drug	
GRIN1	drug_target	
Trazodone	drug	
Degarelix	drug	
Bromocriptine	drug	
Amoxapine	drug	
GABRA1	drug_target	
Midodrine	drug	
Fentanyl	drug	
Octreotide	drug	
Hyaluronidase	drug	
TGFB1	drug_target	
Dicyclomine	drug	
Salmeterol	drug	
Cinacalcet	drug	
CASR	drug_target	
Levodopa	drug	
SLC7A8	drug_target	
SLC7A5	drug_target	
Remifentanil	drug	
Citalopram	drug	
Promethazine	drug	
Buspirone	drug	
Losartan	drug	
UGT1A1	drug_target	
AGTR1	drug_target	
UGT1A3	drug_target	
UGT1A10	drug_target	
SLC22A12	drug_target	
Cevimeline	drug	
FMO1	drug_target	
Scopolamine	drug	
SI	drug_target	
Eculizumab	drug	
C5	drug_target	
Tesamorelin	drug	
GHRHR	drug_target	
Naphazoline	drug	
Levonorgestrel	drug	
SRD5A1	drug_target	
Goserelin	drug	
LHCGR	drug_target	
Olanzapine	drug	
Ropinirole	drug	
Donepezil	drug	
ACHE	drug_target	
Atropine	drug	
Protirelin	drug	
TRHR	drug_target	
Bivalirudin	drug	
F2	drug_target	
Cyclopentolate	drug	
Methamphetamine	drug	
Ramucirumab	drug	
Progesterone	drug	
ABCC1	drug_target	
NR3C2	drug_target	
Nortriptyline	drug	
Ketoprofen	drug	
ABCC4	drug_target	
SLC22A11	drug_target	
CXCR1	drug_target	
Propantheline	drug	
Acitretin	drug	
RBP1	drug_target	
CYP26A1	drug_target	
RARG	drug_target	
RARB	drug_target	
RXRG	drug_target	
RXRB	drug_target	
RARA	drug_target	
RXRA	drug_target	
Norgestimate	drug	
Niacin	drug	
SLC16A3	drug_target	
SLC16A1	drug_target	
SLCO2B1	drug_target	
HCAR3	drug_target	
HCAR2	drug_target	
QPRT	drug_target	
NNMT	drug_target	
SLC5A8	drug_target	
Estradiol	drug	
ABCC10	drug_target	
NR1I2	drug_target	
SLCO1B3	drug_target	
SLCO1C1	drug_target	
ESR2	drug_target	
SLCO4A1	drug_target	
FABP2	drug_target	
Dronabinol	drug	
Menthol	drug	
TRPM8	drug_target	
Ipratropium bromide	drug	
Isometheptene	drug	
Lurasidone	drug	
Terbutaline	drug	
Droxidopa	drug	
Allopurinol	drug	
Dihydroergotamine	drug	
Apraclonidine	drug	
Famotidine	drug	
Dasatinib	drug	
ABL2	drug_target	
EPHA2	drug_target	
YES1	drug_target	
STAT5B	drug_target	
FYN	drug_target	
Pertuzumab	drug	
ERBB2	drug_target	
Rizatriptan	drug	
Naltrexone	drug	
Hyoscyamine	drug	
Metoprolol	drug	
Doxepin	drug	
Cyproheptadine	drug	
Mirtazapine	drug	
Phentolamine	drug	
Tenecteplase	drug	
PLG	drug_target	
FGA	drug_target	
PLAUR	drug_target	
SERPINE1	drug_target	
SERPINB2	drug_target	
CALR	drug_target	
CANX	drug_target	
LRP1	drug_target	
CLEC3B	drug_target	
KRT8	drug_target	
ANXA2	drug_target	
Nefazodone	drug	
Clonidine	drug	
Hydromorphone	drug	
Cetirizine	drug	
Rocuronium	drug	
Nepafenac	drug	
Frovatriptan	drug	
Bosutinib	drug	
HCK	drug_target	
CDK2	drug_target	
MAP2K1	drug_target	
MAP2K2	drug_target	
MAP3K2	drug_target	
CAMK2G	drug_target	
Conivaptan	drug	
AVPR2	drug_target	
AVPR1A	drug_target	
Phenylephrine	drug	
Oxymorphone	drug	
Pilocarpine	drug	
Nalbuphine	drug	
Prasugrel	drug	
Pimozide	drug	
Trihexyphenidyl	drug	
Azelastine	drug	
Acamprosate	drug	
GRM5	drug_target	
Loxapine	drug	
Solifenacin	drug	
Trimipramine	drug	
Almotriptan	drug	
Febuxostat	drug	
Ephedrine	drug	
Pentazocine	drug	
Leuprolide	drug	
Gabapentin	drug	
BCAT1	drug_target	
CACNA2D1	drug_target	
CACNA2D2	drug_target	
CACNA1B	drug_target	
Regorafenib	drug	
BRAF	drug_target	
RAF1	drug_target	
MAPK11	drug_target	
DDR2	drug_target	
FRK	drug_target	
Vigabatrin	drug	
GABBR1	drug_target	
Amphetamine	drug	
CARTPT	drug_target	
Desogestrel	drug	
Clemastine	drug	
Mirabegron	drug	
Risperidone	drug	
Iloprost	drug	
PLAT	drug_target	
PDE4B	drug_target	
PDE4D	drug_target	
PDE4A	drug_target	
SLCO3A1	drug_target	
PTGER1	drug_target	
PTGIR	drug_target	
PDE4C	drug_target	
Timolol	drug	
Insulin Detemir	drug	
Terazosin	drug	
KCNH6	drug_target	
KCNH7	drug_target	
Metipranolol	drug	
Oxycodone	drug	
Morphine	drug	
UGT2B15	drug_target	
UGT1A8	drug_target	
Triamcinolone	drug	
SERPINA6	drug_target	
Ibuprofen	drug	
THBD	drug_target	
CFTR	drug_target	
BCL2	drug_target	
Sumatriptan	drug	
Ketamine	drug	
TACR1	drug_target	
Sotalol	drug	
Metoclopramide	drug	
CYP11B2	drug_target	
Nabumetone	drug	
Pramipexole	drug	
Paliperidone	drug	
Piroxicam	drug	
Aripiprazole	drug	
Drospirenone	drug	
Sorafenib	drug	
RALBP1	drug_target	
Oxcarbazepine	drug	
SCN5A	drug_target	
Pergolide	drug	
Etomidate	drug	
SLC2A1	drug_target	
Arformoterol	drug	
Renal hypertension	phenotype	
Meclofenamic acid	drug	
ALOX5	drug_target	
Oxymetazoline	drug	
Dalteparin	drug	
TFPI	drug_target	
VEGFA	drug_target	
SELP	drug_target	
HPSE	drug_target	
Azathioprine	drug	
GSTA1	drug_target	
GSTA2	drug_target	
HPRT1	drug_target	
TPMT	drug_target	
Cysteamine	drug	
SST	drug_target	
NPY2R	drug_target	
Sargramostim	drug	
CSF2RA	drug_target	
IL3RA	drug_target	
CSF2RB	drug_target	
SDC2	drug_target	
PRG2	drug_target	
Fenoprofen	drug	
Vandetanib	drug	
EGFR	drug_target	
PTK6	drug_target	
Indacaterol	drug	
Indomethacin	drug	
ABCC3	drug_target	
GLO1	drug_target	
ABCC11	drug_target	
CES1	drug_target	
PLA2G2A	drug_target	
PTGR2	drug_target	
PTGDR2	drug_target	
PPARA	drug_target	
ABCC6	drug_target	
Formoterol	drug	
Naloxone	drug	
CREB1	drug_target	
TLR4	drug_target	
Bazedoxifene	drug	
Darbepoetin alfa	drug	
EPOR	drug_target	
Mefloquine	drug	
HBA2	drug_target	
Tizanidine	drug	
NISCH	drug_target	
Travoprost	drug	
PTGFR	drug_target	
Mometasone	drug	
Ketorolac	drug	
Zidovudine	drug	
ABCC5	drug_target	
TK1	drug_target	
SLC28A1	drug_target	
SLC29A2	drug_target	
TERT	drug_target	
Tolmetin	drug	
TDO2	drug_target	
Sunitinib	drug	
Tofacitinib	drug	
JAK2	drug_target	
JAK1	drug_target	
JAK3	drug_target	
UTS2B	intermediate	
EDNRA	intermediate	
EDNRB	intermediate	
EDN1	intermediate	
TAC1	intermediate	
F2RL1	intermediate	
NPS	intermediate	
BDKRB2	intermediate	
CYSLTR1	intermediate	
TACR2	intermediate	
UTS2	intermediate	
AGT	intermediate	
GCG	intermediate	
GPR17	intermediate	
KNG1	intermediate	
RLN3	intermediate	
LPAR3	intermediate	
GCGR	intermediate	
POMC	intermediate	
APLNR	intermediate	
SAA1	intermediate	
NMU	intermediate	
NMUR2	intermediate	
CCL5	intermediate	
PMCH	intermediate	
CALCA	intermediate	
CXCR2	intermediate	
NMUR1	intermediate	
VIP	intermediate	
CCL23	intermediate	
NPSR1	intermediate	
APP	intermediate	
GNB1	intermediate	
BDKRB1	intermediate	
P2RY11	intermediate	
CCR7	intermediate	
LPAR2	intermediate	
ADM	intermediate	
LPAR1	intermediate	
RAMP2	intermediate	
NMS	intermediate	
NPY	intermediate	
GNG2	intermediate	
CXCL8	intermediate	
LPAR5	intermediate	
TAS2R50	intermediate	
CXCL10	intermediate	
CCL16	intermediate	
MCHR1	intermediate	
TAS2R46	intermediate	
CXCL3	intermediate	
CXCL11	intermediate	
TAS2R40	intermediate	
GRM7	intermediate	
ADORA3	intermediate	
CXCR5	intermediate	
S1PR1	intermediate	
CCR10	intermediate	
NPW	intermediate	
HEBP1	intermediate	
CCL28	intermediate	
NPY4R	intermediate	
TAS2R4	intermediate	
CXCL16	intermediate	
PF4	intermediate	
TAS2R60	intermediate	
PPBP	intermediate	
TAS2R7	intermediate	
CCR3	intermediate	
S1PR4	intermediate	
C3	intermediate	
GNAI1	intermediate	
GNAT3	intermediate	
GPR55	intermediate	
S1PR5	intermediate	
TAS2R20	intermediate	
CCL21	intermediate	
P2RY4	intermediate	
NPBWR1	intermediate	
CCR8	intermediate	
TAS2R10	intermediate	
CXCL6	intermediate	
GALR2	intermediate	
TAS2R42	intermediate	
ACKR3	intermediate	
C3AR1	intermediate	
CXCR3	intermediate	
TAS2R14	intermediate	
OXGR1	intermediate	
GABBR2	intermediate	
TAS2R9	intermediate	
P2RY14	intermediate	
TAS2R1	intermediate	
FPR3	intermediate	
TAS2R43	intermediate	
PENK	intermediate	
TAS2R8	intermediate	
PDYN	intermediate	
AGTR2	intermediate	
CCR5	intermediate	
PTGER3	intermediate	
TAS2R19	intermediate	
CXCL5	intermediate	
RXFP4	intermediate	
CXCL1	intermediate	
CORT	intermediate	
CXCL2	intermediate	
GNAI3	intermediate	
OXER1	intermediate	
RXFP3	intermediate	
CXCL13	intermediate	
OPRL1	intermediate	
APLN	intermediate	
CCL19	intermediate	
CCR6	intermediate	
TAS2R38	intermediate	
GRM8	intermediate	
SUCNR1	intermediate	
TAS2R39	intermediate	
TAS2R41	intermediate	
CCL27	intermediate	
NPY5R	intermediate	
TAS2R3	intermediate	
complex:lAo9+jzjVOaRJSWZQvoh0G1mUDc	intermediate	
CCR2	intermediate	
PYY	intermediate	
S1PR2	intermediate	
CCR4	intermediate	
GAL	intermediate	
FPR1	intermediate	
MCHR2	intermediate	
CCR1	intermediate	
HCAR1	intermediate	
GRM2	intermediate	
CCR9	intermediate	
PNOC	intermediate	
TAS2R45	intermediate	
TAS2R13	intermediate	
TAS2R31	intermediate	
CXCL9	intermediate	
CCL25	intermediate	
MTNR1A	intermediate	
TAS2R16	intermediate	
SSTR4	intermediate	
PPY	intermediate	
CXCR6	intermediate	
INSL5	intermediate	
C5AR1	intermediate	
APOE	intermediate	
GRM4	intermediate	
NPB	intermediate	
NPY1R	intermediate	
CXCR4	intermediate	
TAS2R5	intermediate	
P2RY13	intermediate	
GPER1	intermediate	
GALR3	intermediate	
FPR2	intermediate	
NPBWR2	intermediate	
GRM6	intermediate	
MT-RNR2	intermediate	
GALR1	intermediate	
S1PR3	intermediate	
MTNR1B	intermediate	
TAS2R30	intermediate	
GNAI2	intermediate	
CCL20	intermediate	
SHC1	intermediate	
ROCK1	intermediate	
CDC42	intermediate	
PIK3R1	intermediate	
FRS2	intermediate	
PECAM1	intermediate	
EPHB2	intermediate	
HRAS	intermediate	
MAPK3	intermediate	
F2R	intermediate	
HLA-DRB1	intermediate	
PIK3CA	intermediate	
ROCK2	intermediate	
NCK1	intermediate	
PIK3R2	intermediate	
MAPK1	intermediate	
FGF2	intermediate	
CD47	intermediate	
EFNA1	intermediate	
PTK2B	intermediate	
PDGFB	intermediate	
PTPN11	intermediate	
PLCG1	intermediate	
ANGPT1	intermediate	
CRK	intermediate	
HSP90AA1	intermediate	
HGF	intermediate	
EGF	intermediate	
GRB2	intermediate	
KITLG	intermediate	
PIK3CB	intermediate	
SOS1	intermediate	
GAB2	intermediate	
PDGFA	intermediate	
P2RY2	intermediate	
GNAS	intermediate	
FSHR	intermediate	
CALCRL	intermediate	
PTH	intermediate	
ATM	intermediate	
FN1	intermediate	
CYSLTR2	intermediate	
SCARB2	intermediate	
OXTR	intermediate	
LTB4R2	intermediate	
PROKR1	intermediate	
LTB4R	intermediate	
CCK	intermediate	
OPN4	intermediate	
F2RL3	intermediate	
HCRTR1	intermediate	
GPR65	intermediate	
NPFFR1	intermediate	
DNM2	intermediate	
P2RY1	intermediate	
NMBR	intermediate	
GNRHR2	intermediate	
LDLR	intermediate	
QRFP	intermediate	
XCL2	intermediate	
OXT	intermediate	
EDN2	intermediate	
TAC3	intermediate	
EDN3	intermediate	
GPRC6A	intermediate	
CCKAR	intermediate	
GHRL	intermediate	
APOB	intermediate	
NPFFR2	intermediate	
GNA14	intermediate	
TACR3	intermediate	
HP	intermediate	
GNRH1	intermediate	
GNA11	intermediate	
NTSR1	intermediate	
NTSR2	intermediate	
GNA15	intermediate	
GPR132	intermediate	
KISS1	intermediate	
MLNR	intermediate	
P2RY6	intermediate	
XCR1	intermediate	
GRP	intermediate	
TRH	intermediate	
KISS1R	intermediate	
NTS	intermediate	
CCKBR	intermediate	
PROK2	intermediate	
HCRT	intermediate	
GRPR	intermediate	
XCL1	intermediate	
P2RY10	intermediate	
UTS2R	intermediate	
KCNMA1	intermediate	
GPR4	intermediate	
GNRH2	intermediate	
GRM1	intermediate	
AVPR1B	intermediate	
PROK1	intermediate	
FFAR2	intermediate	
LPAR6	intermediate	
GPR68	intermediate	
GAST	intermediate	
F2RL2	intermediate	
NMB	intermediate	
PTAFR	intermediate	
GNAQ	intermediate	
FFAR3	intermediate	
FFAR1	intermediate	
HCRTR2	intermediate	
QRFPR	intermediate	
MLN	intermediate	
NPFF	intermediate	
PROKR2	intermediate	
LPAR4	intermediate	
GHSR	intermediate	
MGST3	intermediate	
TSHR	intermediate	
VIPR2	intermediate	
GPR27	intermediate	
GIP	intermediate	
RXFP1	intermediate	
CRHR1	intermediate	
RAMP1	intermediate	
CRH	intermediate	
PTHLH	intermediate	
GHRH	intermediate	
GPR32	intermediate	
MC2R	intermediate	
GPR83	intermediate	
LHB	intermediate	
PTGDR	intermediate	
PTGER4	intermediate	
PTGER2	intermediate	
GPR150	intermediate	
GPBAR1	intermediate	
SCT	intermediate	
TSHB	intermediate	
ADM2	intermediate	
RAMP3	intermediate	
VIPR1	intermediate	
GPHB5	intermediate	
GIPR	intermediate	
ADCYAP1	intermediate	
IAPP	intermediate	
CGA	intermediate	
MC1R	intermediate	
PTH2	intermediate	
GPR84	intermediate	
GPHA2	intermediate	
GPR45	intermediate	
GLP2R	intermediate	
INSL3	intermediate	
PTH2R	intermediate	
MC3R	intermediate	
ADCYAP1R1	intermediate	
RLN2	intermediate	
CALCR	intermediate	
FSHB	intermediate	
GPR176	intermediate	
GPR20	intermediate	
MC5R	intermediate	
RXFP2	intermediate	
CALCB	intermediate	
SCTR	intermediate	
GPR25	intermediate	
GPR15	intermediate	
APOA4	intermediate	
APOA1	intermediate	
APOC3	intermediate	
PTK2	intermediate	
NFATC3	intermediate	
CAV1	intermediate	
AKT1	intermediate	
rs1800629	intermediate	
INPPL1	intermediate	
LTA	intermediate	
MYLK	intermediate	
MGST2	intermediate	
CST3	intermediate	
AVP	intermediate	
APOC1	intermediate	
LDLRAP1	intermediate	
MGST1	intermediate	
GNA12	intermediate	
LRP2	intermediate	
M6PR	intermediate	
HGS	intermediate	
GRB7	intermediate	
KLB	intermediate	
NRG1	intermediate	
FGF6	intermediate	
FGF4	intermediate	
FGF19	intermediate	
BTC	intermediate	
FGF9	intermediate	
FGF16	intermediate	
FGF20	intermediate	
FGF3	intermediate	
FGF1	intermediate	
ERBB4	intermediate	
HBEGF	intermediate	
FGF22	intermediate	
FGF7	intermediate	
FGF8	intermediate	
NRG4	intermediate	
FGF5	intermediate	
FGF23	intermediate	
FGF17	intermediate	
FGF10	intermediate	
FGF18	intermediate	
EREG	intermediate	
KL	intermediate	
STAT1	intermediate	
STAT3	intermediate	
IRS1	intermediate	
INS	intermediate	
IGF1	intermediate	
PTPN1	intermediate	
IRS2	intermediate	
RHOA	intermediate	
PXN	intermediate	
EPHA8	intermediate	
HLA-DPB1	intermediate	
FGB	intermediate	
VWF	intermediate	
PPP3R1	intermediate	
CFH	intermediate	
TTR	intermediate	
F7	intermediate	
RYR2	intermediate	
GRAP2	intermediate	
PALB2	intermediate	
DMD	intermediate	
NPHS1	intermediate	
ITGA2	intermediate	
TIAM1	intermediate	
F5	intermediate	
ITGAV	intermediate	
ITGB3	intermediate	
CRABP2	intermediate	
NCOA3	intermediate	
PPFIA4	intermediate	
PPP3CA	intermediate	
STAT5A	intermediate	
CRMP1	intermediate	
CSF2	intermediate	
IL5	intermediate	
IL3	intermediate	
ERBB3	intermediate	
CSK	intermediate	
TAP1	intermediate	
FGG	intermediate	
RAP1A	intermediate	
ITGA2B	intermediate	
RAP1B	intermediate	
APBB1IP	intermediate	
GP1BB	intermediate	
rs5760410	intermediate	
SPECC1L	intermediate	
TRIM24	intermediate	
AKAP9	intermediate	
NRAS	intermediate	
KRAS	intermediate	
PPARGC1A	intermediate	
CRKL	intermediate	
ADCY3	intermediate	
ADCY1	intermediate	
ADCY4	intermediate	
ADCY7	intermediate	
ADCY5	intermediate	
ADCY8	intermediate	
ADCY6	intermediate	
ADCY9	intermediate	
TP53	intermediate	
DERL1	intermediate	
ALOX5AP	intermediate	
LAT	intermediate	
TGFBR1	intermediate	
SMAD3	intermediate	
SMAD2	intermediate	
TGFBR2	intermediate	
NCOR2	intermediate	
MED1	intermediate	
NCOR1	intermediate	
HDAC3	intermediate	
NGF	intermediate	
EPHB1	intermediate	
SH2B1	intermediate	
