Indomethacin	drug	
PTGS2	drug_target	
ABCB1	drug_target	
PTGS1	drug_target	
CYP2C9	drug_target	
UGT1A9	drug_target	
ABCC2	drug_target	
ALB	drug_target	
CYP2C19	drug_target	
ABCC3	drug_target	
ABCC1	drug_target	
SLCO1A2	drug_target	
SLC10A1	drug_target	
SLC22A6	drug_target	
SLC22A8	drug_target	
GLO1	drug_target	
ABCC4	drug_target	
ABCC11	drug_target	
PPARG	drug_target	
SLC22A11	drug_target	
UGT1A1	drug_target	
UGT2B7	drug_target	
CES1	drug_target	
PLA2G2A	drug_target	
PTGR2	drug_target	
PTGDR2	drug_target	
PPARA	drug_target	
ABCC6	drug_target	
Acute myocardial infarction	phenotype	
Bevacizumab	drug	
FCGR3B	drug_target	
C1R	drug_target	
C1QA	drug_target	
C1QB	drug_target	
C1QC	drug_target	
FCGR3A	drug_target	
FCGR1A	drug_target	
FCGR2A	drug_target	
FCGR2B	drug_target	
FCGR2C	drug_target	
VEGFA	drug_target	
Anterior myocardial infarction	phenotype	
Fluoxetine	drug	
CYP1A2	drug_target	
CYP2D6	drug_target	
CYP3A4	drug_target	
CYP3A5	drug_target	
CYP2B6	drug_target	
SLC6A4	drug_target	
ORM1	drug_target	
Old myocardial infarction	phenotype	
Levothyroxine	drug	
CYP2C8	drug_target	
SLCO1B1	drug_target	
SLC16A2	drug_target	
SLCO1B3	drug_target	
SLCO1C1	drug_target	
TTR	drug_target	
THRA	drug_target	
THRB	drug_target	
SERPINA7	drug_target	
SLCO4A1	drug_target	
SLC7A5	drug_target	
Olanzapine	drug	
DRD2	drug_target	
CHRM3	drug_target	
CHRM1	drug_target	
HTR2C	drug_target	
CHRM2	drug_target	
ADRA1A	drug_target	
ADRA1B	drug_target	
HRH1	drug_target	
HTR1D	drug_target	
HTR1B	drug_target	
HTR1A	drug_target	
HTR1E	drug_target	
HTR2B	drug_target	
HTR7	drug_target	
HTR2A	drug_target	
DRD1	drug_target	
DRD5	drug_target	
DRD3	drug_target	
DRD4	drug_target	
HTR3A	drug_target	
HTR6	drug_target	
ADRA2A	drug_target	
ADRA2B	drug_target	
ADRA2C	drug_target	
CHRM4	drug_target	
CHRM5	drug_target	
FMO3	drug_target	
HRH2	drug_target	
HRH4	drug_target	
HTR5A	drug_target	
Celecoxib	drug	
PDPK1	drug_target	
Myocardial Infarction	phenotype	
Piroxicam	drug	
Tacrolimus	drug	
FKBP1A	drug_target	
ABCA5	drug_target	
Eletriptan	drug	
CYP2A6	drug_target	
HTR1F	drug_target	
Amphetamine	drug	
SLC22A3	drug_target	
SLC22A5	drug_target	
SLC18A2	drug_target	
SLC6A3	drug_target	
CARTPT	drug_target	
TAAR1	drug_target	
SLC6A2	drug_target	
MAOB	drug_target	
Pergolide	drug	
ADRA1D	drug_target	
Atropine	drug	
Apomorphine	drug	
CALY	drug_target	
Fenoprofen	drug	
Metoclopramide	drug	
CYP17A1	drug_target	
CYP11B2	drug_target	
HTR4	drug_target	
Sapropterin	drug	
PAH	drug_target	
TH	drug_target	
NOS3	drug_target	
TPH1	drug_target	
Enalapril	drug	
ACE	drug_target	
Pentazocine	drug	
OPRM1	drug_target	
OPRK1	drug_target	
SIGMAR1	drug_target	
Glyburide	drug	
ABCB11	drug_target	
ABCG2	drug_target	
ABCA1	drug_target	
ABCC9	drug_target	
SLCO2B1	drug_target	
SLC15A2	drug_target	
CPT1A	drug_target	
CFTR	drug_target	
KCNJ5	drug_target	
Clozapine	drug	
CYP2E1	drug_target	
CYP1B1	drug_target	
CYP1A1	drug_target	
UGT1A4	drug_target	
Irbesartan	drug	
AGTR1	drug_target	
UGT1A3	drug_target	
JUN	drug_target	
Dextroamphetamine	drug	
Estrone	drug	
CYP4A11	drug_target	
ESR1	drug_target	
Risperidone	drug	
Pasireotide	drug	
SSTR1	drug_target	
SSTR5	drug_target	
SSTR2	drug_target	
SSTR3	drug_target	
Danazol	drug	
GNRHR	drug_target	
CYP19A1	drug_target	
PGR	drug_target	
AR	drug_target	
SHBG	drug_target	
CCL2	drug_target	
Amitriptyline	drug	
OPRD1	drug_target	
KCNA1	drug_target	
KCND2	drug_target	
KCND3	drug_target	
NTRK1	drug_target	
NTRK2	drug_target	
KCNQ2	drug_target	
KCNQ3	drug_target	
Ketoprofen	drug	
CXCR1	drug_target	
Naratriptan	drug	
MAOA	drug_target	
Bromocriptine	drug	
Propranolol	drug	
SLC22A2	drug_target	
ADRB1	drug_target	
ADRB2	drug_target	
ADRB3	drug_target	
Trazodone	drug	
Epinephrine	drug	
TNF	drug_target	
SLC22A1	drug_target	
Sumatriptan	drug	
Lidocaine	drug	
EGFR	drug_target	
CYP2C18	drug_target	
SCN5A	drug_target	
SCN10A	drug_target	
Nalbuphine	drug	
Erlotinib	drug	
NR1I2	drug_target	
Progesterone	drug	
NR3C2	drug_target	
Zidovudine	drug	
ABCC5	drug_target	
TK1	drug_target	
SLC28A1	drug_target	
SLC29A2	drug_target	
TERT	drug_target	
Trimipramine	drug	
Naproxen	drug	
Aprotinin	drug	
PLG	drug_target	
PRSS1	drug_target	
KLK1	drug_target	
Mirtazapine	drug	
HRH3	drug_target	
Leuprolide	drug	
Ramipril	drug	
BCHE	drug_target	
Disopyramide	drug	
Fosinopril	drug	
Abciximab	drug	
C1S	drug_target	
ITGB3	drug_target	
ITGA2B	drug_target	
VTN	drug_target	
Alteplase	drug	
FGA	drug_target	
PLAUR	drug_target	
SERPINE1	drug_target	
Maprotiline	drug	
Propofol	drug	
UGT1A6	drug_target	
UGT1A8	drug_target	
GABRB2	drug_target	
GABRB3	drug_target	
FAAH	drug_target	
SCN2A	drug_target	
SCN4A	drug_target	
Etodolac	drug	
UGT1A10	drug_target	
RXRA	drug_target	
Losartan	drug	
SLC22A12	drug_target	
Methyltestosterone	drug	
Repaglinide	drug	
ABCC8	drug_target	
Clomipramine	drug	
GSTP1	drug_target	
Quinapril	drug	
Diclofenac	drug	
ALOX5	drug_target	
ASIC1	drug_target	
Fondaparinux sodium	drug	
F10	drug_target	
SERPINC1	drug_target	
Dexamethasone	drug	
NOS2	drug_target	
CYP11A1	drug_target	
NR3C1	drug_target	
ANXA1	drug_target	
CYP3A43	drug_target	
NR0B1	drug_target	
Tenecteplase	drug	
SERPINB2	drug_target	
CALR	drug_target	
CANX	drug_target	
LRP1	drug_target	
CLEC3B	drug_target	
KRT8	drug_target	
ANXA2	drug_target	
Nafarelin	drug	
Lisdexamfetamine	drug	
Octreotide	drug	
MPO	drug_target	
Almotriptan	drug	
Goserelin	drug	
LHCGR	drug_target	
Clonidine	drug	
SLC22A4	drug_target	
Cyclobenzaprine	drug	
Perphenazine	drug	
CALM3	drug_target	
Ibuprofen	drug	
PLAT	drug_target	
THBD	drug_target	
UGT2B4	drug_target	
FABP2	drug_target	
BCL2	drug_target	
Nortriptyline	drug	
Dihydroergotamine	drug	
Trandolapril	drug	
Flurbiprofen	drug	
Liothyronine	drug	
SLC16A10	drug_target	
Benazepril	drug	
MTHFR	drug_target	
Nicardipine	drug	
CACNA1C	drug_target	
CACNA2D1	drug_target	
CACNB2	drug_target	
CACNA1D	drug_target	
PDE1A	drug_target	
PDE1B	drug_target	
Phenylephrine	drug	
Adalimumab	drug	
Sotalol	drug	
KCNH2	drug_target	
Captopril	drug	
MMP2	drug_target	
MMP9	drug_target	
LTA4H	drug_target	
Diflunisal	drug	
Tranexamic Acid	drug	
Phentolamine	drug	
Pilocarpine	drug	
Pindolol	drug	
Estradiol	drug	
ABCC10	drug_target	
ESR2	drug_target	
Amoxapine	drug	
GABRA1	drug_target	
Zolmitriptan	drug	
Fentanyl	drug	
Escitalopram	drug	
Fluorouracil	drug	
PPAT	drug_target	
SLC29A1	drug_target	
TYMS	drug_target	
TYMP	drug_target	
DPYD	drug_target	
UPP1	drug_target	
UPP2	drug_target	
UMPS	drug_target	
Desipramine	drug	
SMPD1	drug_target	
Enalaprilat	drug	
Insulin Human	drug	
LRP2	drug_target	
INSR	drug_target	
IGF1R	drug_target	
RB1	drug_target	
CTSD	drug_target	
IDE	drug_target	
PCSK2	drug_target	
CPE	drug_target	
PCSK1	drug_target	
NOV	drug_target	
IGFBP7	drug_target	
SYTL4	drug_target	
Salicylic acid	drug	
SLC16A1	drug_target	
AKR1C1	drug_target	
Salsalate	drug	
Infliximab	drug	
Heparin	drug	
SELP	drug_target	
HPSE	drug_target	
Diphenhydramine	drug	
Rosiglitazone	drug	
ACSL4	drug_target	
Testosterone	drug	
CYP2A13	drug_target	
Triptorelin	drug	
Naloxone	drug	
CREB1	drug_target	
TLR4	drug_target	
Valsartan	drug	
Fenoldopam	drug	
Ketorolac	drug	
Adenosine	drug	
ADK	drug_target	
ADA	drug_target	
ADORA1	drug_target	
ADORA2A	drug_target	
SLC28A3	drug_target	
ADORA2B	drug_target	
Maraviroc	drug	
CCR5	drug_target	
Citalopram	drug	
Pseudoephedrine	drug	
NFATC1	drug_target	
IL2	drug_target	
Imipramine	drug	
Aripiprazole	drug	
Pramipexole	drug	
Dasatinib	drug	
PDGFRB	drug_target	
ABL2	drug_target	
ABL1	drug_target	
KIT	drug_target	
SRC	drug_target	
EPHA2	drug_target	
LCK	drug_target	
YES1	drug_target	
STAT5B	drug_target	
FYN	drug_target	
Lisinopril	drug	
ACE2	drug_target	
Prednisone	drug	
HSD11B1	drug_target	
Tolmetin	drug	
TDO2	drug_target	
Acamprosate	drug	
GRM5	drug_target	
Certolizumab pegol	drug	
Hyaluronidase	drug	
TGFB1	drug_target	
Ropinirole	drug	
Tramadol	drug	
GRIN3A	drug_target	
Abiraterone	drug	
SULT2A1	drug_target	
Tropicamide	drug	
Rizatriptan	drug	
Tinzaparin	drug	
ITGA4	drug_target	
CXCL12	drug_target	
ADAMTS4	drug_target	
Telmisartan	drug	
Lurasidone	drug	
Doxazosin	drug	
KCNH6	drug_target	
KCNH7	drug_target	
Desflurane	drug	
GRIA1	drug_target	
GLRA1	drug_target	
MT-ND1	drug_target	
ATP2C1	drug_target	
ATP5D	drug_target	
Hydroxyzine	drug	
Histrelin	drug	
Memantine	drug	
GRIN1	drug_target	
GRIN2A	drug_target	
GRIN2B	drug_target	
Paroxetine	drug	
Frovatriptan	drug	
Gabapentin	drug	
BCAT1	drug_target	
CACNA2D2	drug_target	
CACNA1B	drug_target	
Vorinostat	drug	
HDAC2	drug_target	
HDAC1	drug_target	
HDAC3	drug_target	
HDAC6	drug_target	
HDAC8	drug_target	
Menthol	drug	
TRPM8	drug_target	
Sulindac	drug	
AKR1B1	drug_target	
PPARD	drug_target	
MAPK3	drug_target	
Donepezil	drug	
ACHE	drug_target	
Candesartan	drug	
Olmesartan	drug	
Levodopa	drug	
DDC	drug_target	
SLC7A8	drug_target	
complex:lAo9+jzjVOaRJSWZQvoh0G1mUDc	intermediate	
CST3	intermediate	
MED1	intermediate	
APOA1	intermediate	
ITGA2	intermediate	
F7	intermediate	
APOE	intermediate	
NCOR1	intermediate	
PPBP	intermediate	
NCOR2	intermediate	
DMD	intermediate	
HP	intermediate	
ELMO1	intermediate	
ELMO2	intermediate	
APOA4	intermediate	
NMUR1	intermediate	
TAS2R40	intermediate	
CCR6	intermediate	
CCR3	intermediate	
TAS2R20	intermediate	
BDKRB2	intermediate	
LPAR1	intermediate	
P2RY11	intermediate	
S1PR1	intermediate	
NPBWR1	intermediate	
GPR17	intermediate	
APP	intermediate	
NPY4R	intermediate	
GABBR2	intermediate	
TAS2R16	intermediate	
TAS2R60	intermediate	
CCL21	intermediate	
FPR2	intermediate	
GNG2	intermediate	
NMU	intermediate	
FPR1	intermediate	
GPR55	intermediate	
GRM2	intermediate	
NPB	intermediate	
HEBP1	intermediate	
PDYN	intermediate	
CXCR4	intermediate	
CCL5	intermediate	
C3	intermediate	
CCL16	intermediate	
CCL23	intermediate	
GRM8	intermediate	
TAS2R4	intermediate	
TAS2R7	intermediate	
TAS2R43	intermediate	
CCR1	intermediate	
SUCNR1	intermediate	
GCG	intermediate	
NMS	intermediate	
TAS2R8	intermediate	
S1PR2	intermediate	
PPY	intermediate	
CXCL5	intermediate	
RXFP4	intermediate	
TAS2R41	intermediate	
S1PR5	intermediate	
C5	intermediate	
APOB	intermediate	
PF4	intermediate	
GPR18	intermediate	
CXCL3	intermediate	
TAS2R45	intermediate	
CASR	intermediate	
CXCR3	intermediate	
CXCL11	intermediate	
TAS2R46	intermediate	
CXCL6	intermediate	
SSTR4	intermediate	
TAS2R50	intermediate	
NPY2R	intermediate	
CNR2	intermediate	
CXCR5	intermediate	
P2RY13	intermediate	
CXCR2	intermediate	
CXCL13	intermediate	
KNG1	intermediate	
GRM6	intermediate	
CCL28	intermediate	
LPAR2	intermediate	
CCR2	intermediate	
C5AR1	intermediate	
INSL5	intermediate	
ADORA3	intermediate	
GRM4	intermediate	
MT-RNR2	intermediate	
CXCL16	intermediate	
OPRL1	intermediate	
APLNR	intermediate	
TAS2R9	intermediate	
POMC	intermediate	
NPBWR2	intermediate	
P2RY4	intermediate	
PMCH	intermediate	
MCHR1	intermediate	
CCR7	intermediate	
GNAI1	intermediate	
HCAR2	intermediate	
HCAR3	intermediate	
GALR3	intermediate	
TAS2R31	intermediate	
TAS2R19	intermediate	
CXCL9	intermediate	
FPR3	intermediate	
GNAT3	intermediate	
NPY1R	intermediate	
GNB1	intermediate	
GNAI3	intermediate	
CXCL8	intermediate	
AGTR2	intermediate	
S1PR4	intermediate	
PNOC	intermediate	
TAS2R3	intermediate	
CXCL10	intermediate	
TAS2R1	intermediate	
TAS2R14	intermediate	
AGT	intermediate	
TAS2R10	intermediate	
MCHR2	intermediate	
NPY	intermediate	
NPS	intermediate	
PTGER3	intermediate	
CCR10	intermediate	
RLN3	intermediate	
F2	intermediate	
OXER1	intermediate	
PENK	intermediate	
CXCL1	intermediate	
GALR2	intermediate	
LPAR5	intermediate	
P2RY12	intermediate	
CXCR6	intermediate	
CCR8	intermediate	
LPAR3	intermediate	
NPY5R	intermediate	
SAA1	intermediate	
GAL	intermediate	
S1PR3	intermediate	
C3AR1	intermediate	
TAS2R39	intermediate	
CORT	intermediate	
TAS2R38	intermediate	
CCL20	intermediate	
GALR1	intermediate	
CXCL2	intermediate	
PYY	intermediate	
MTNR1B	intermediate	
OXGR1	intermediate	
ACKR3	intermediate	
TAS2R5	intermediate	
HCAR1	intermediate	
TAS2R30	intermediate	
BDKRB1	intermediate	
GCGR	intermediate	
RXFP3	intermediate	
P2RY14	intermediate	
MTNR1A	intermediate	
GPER1	intermediate	
APLN	intermediate	
NPSR1	intermediate	
GNAI2	intermediate	
NMUR2	intermediate	
GRM7	intermediate	
GABBR1	intermediate	
SST	intermediate	
TAS2R42	intermediate	
CCR4	intermediate	
CCL27	intermediate	
CCR9	intermediate	
CCL25	intermediate	
NPW	intermediate	
CCL19	intermediate	
CNR1	intermediate	
KRT16	intermediate	
PIK3CD	intermediate	
APOC3	intermediate	
PIK3CA	intermediate	
AHSG	intermediate	
APOA2	intermediate	
AKT1	intermediate	
TP53	intermediate	
GSN	intermediate	
FN1	intermediate	
CFH	intermediate	
PIK3CG	intermediate	
CDCP1	intermediate	
GFAP	intermediate	
SERPING1	intermediate	
APOC1	intermediate	
CD28	intermediate	
PIK3CB	intermediate	
KCNMA1	intermediate	
ATM	intermediate	
TGFBR1	intermediate	
EDN1	intermediate	
GHRL	intermediate	
AVPR1A	intermediate	
RLN2	intermediate	
EDNRB	intermediate	
GHSR	intermediate	
UTS2R	intermediate	
TAS2R13	intermediate	
ADM	intermediate	
GHRH	intermediate	
F2R	intermediate	
UTS2	intermediate	
EDNRA	intermediate	
EDN2	intermediate	
RAMP1	intermediate	
F2RL1	intermediate	
PTGER2	intermediate	
P2RY2	intermediate	
FFAR1	intermediate	
PTAFR	intermediate	
PTGER1	intermediate	
FFAR2	intermediate	
GPR65	intermediate	
NTS	intermediate	
NPFFR2	intermediate	
PROK2	intermediate	
HCRT	intermediate	
OXTR	intermediate	
PROKR1	intermediate	
QRFP	intermediate	
CYSLTR1	intermediate	
NPFFR1	intermediate	
PROK1	intermediate	
TRHR	intermediate	
GAST	intermediate	
GRM1	intermediate	
NMB	intermediate	
TACR1	intermediate	
FFAR3	intermediate	
XCL2	intermediate	
EDN3	intermediate	
GNA15	intermediate	
GPR4	intermediate	
F2RL3	intermediate	
P2RY6	intermediate	
GPRC6A	intermediate	
OXT	intermediate	
LPAR6	intermediate	
TAC1	intermediate	
GNRHR2	intermediate	
GPR68	intermediate	
TACR3	intermediate	
TRH	intermediate	
PTGFR	intermediate	
P2RY1	intermediate	
KISS1	intermediate	
AVPR1B	intermediate	
MLNR	intermediate	
P2RY10	intermediate	
XCR1	intermediate	
LTB4R	intermediate	
KISS1R	intermediate	
NTSR1	intermediate	
PROKR2	intermediate	
NTSR2	intermediate	
HCRTR2	intermediate	
TACR2	intermediate	
GNAQ	intermediate	
XCL1	intermediate	
NMBR	intermediate	
LTB4R2	intermediate	
OPN4	intermediate	
GRP	intermediate	
CCK	intermediate	
GNRH2	intermediate	
UTS2B	intermediate	
GNA11	intermediate	
GNRH1	intermediate	
CYSLTR2	intermediate	
GNA14	intermediate	
QRFPR	intermediate	
MLN	intermediate	
GRPR	intermediate	
CCKAR	intermediate	
HCRTR1	intermediate	
GPR132	intermediate	
NPFF	intermediate	
LPAR4	intermediate	
CCKBR	intermediate	
TAC3	intermediate	
F2RL2	intermediate	
PIK3C2A	intermediate	
REN	intermediate	
DERL1	intermediate	
DAB2	intermediate	
VAMP8	intermediate	
TF	intermediate	
LDLRAP1	intermediate	
LDLR	intermediate	
MGST1	intermediate	
MGST3	intermediate	
TBXA2R	intermediate	
IGF2R	intermediate	
MGST2	intermediate	
BRAF	intermediate	
RAMP3	intermediate	
IAPP	intermediate	
PTGDR	intermediate	
SCT	intermediate	
GPR32	intermediate	
GPR84	intermediate	
VIP	intermediate	
VIPR1	intermediate	
RXFP1	intermediate	
CALCB	intermediate	
GPR83	intermediate	
PTH	intermediate	
TSHB	intermediate	
PTHLH	intermediate	
ADCYAP1R1	intermediate	
GPR45	intermediate	
PTH2R	intermediate	
CALCA	intermediate	
RAMP2	intermediate	
RXFP2	intermediate	
GHRHR	intermediate	
GPR20	intermediate	
GPBAR1	intermediate	
LHB	intermediate	
ADM2	intermediate	
PTGER4	intermediate	
GIP	intermediate	
MC1R	intermediate	
GPR150	intermediate	
PTH2	intermediate	
VIPR2	intermediate	
CRHR1	intermediate	
GLP2R	intermediate	
CALCR	intermediate	
GPHA2	intermediate	
PTH1R	intermediate	
GPR176	intermediate	
PTGIR	intermediate	
MC3R	intermediate	
MC2R	intermediate	
CRH	intermediate	
CALCRL	intermediate	
CGA	intermediate	
GIPR	intermediate	
MC5R	intermediate	
ADCYAP1	intermediate	
INSL3	intermediate	
GNAS	intermediate	
SCTR	intermediate	
GPR27	intermediate	
GPR25	intermediate	
FSHR	intermediate	
FSHB	intermediate	
TSHR	intermediate	
GPR15	intermediate	
GPHB5	intermediate	
LTA	intermediate	
rs1800629	intermediate	
PTK2	intermediate	
HGF	intermediate	
IRS1	intermediate	
LRRK2	intermediate	
ANGPT1	intermediate	
SOS1	intermediate	
LAT	intermediate	
PLAU	intermediate	
FGB	intermediate	
VWF	intermediate	
RIPK1	intermediate	
TNFRSF1A	intermediate	
NCOA3	intermediate	
HRG	intermediate	
GRB2	intermediate	
CAV1	intermediate	
MMP1	intermediate	
ALOX15	intermediate	
ALOX5AP	intermediate	
rs8330	intermediate	
rs2070959	intermediate	
rs6759892	intermediate	
FGG	intermediate	
E2F1	intermediate	
IGF2	intermediate	
IGF1	intermediate	
INS	intermediate	
IRS2	intermediate	
F3	intermediate	
CD14	intermediate	
MYD88	intermediate	
PAK3	intermediate	
NRG1	intermediate	
HLA-DQB1	intermediate	
FGFR4	intermediate	
NTN1	intermediate	
PDGFA	intermediate	
FGFR2	intermediate	
LYN	intermediate	
FGF7	intermediate	
GRB7	intermediate	
SH2D2A	intermediate	
SIRPA	intermediate	
JAK2	intermediate	
CDC42	intermediate	
KL	intermediate	
FGF9	intermediate	
FGF16	intermediate	
HLA-DRB1	intermediate	
SHC1	intermediate	
FGF4	intermediate	
FES	intermediate	
FRS2	intermediate	
PECAM1	intermediate	
PIK3R2	intermediate	
FGF20	intermediate	
NRP1	intermediate	
FGF10	intermediate	
FGFR1	intermediate	
FGF6	intermediate	
HRAS	intermediate	
GH1	intermediate	
NCK1	intermediate	
FGF8	intermediate	
HLA-DQA1	intermediate	
MAPK1	intermediate	
ERBB2	intermediate	
KLB	intermediate	
PTPRA	intermediate	
PDCD1	intermediate	
PTPN11	intermediate	
HLA-E	intermediate	
PIK3R1	intermediate	
KITLG	intermediate	
BTC	intermediate	
MET	intermediate	
HBEGF	intermediate	
ERBB4	intermediate	
FGF23	intermediate	
FGF18	intermediate	
NRG4	intermediate	
FGFR3	intermediate	
FGF17	intermediate	
ARHGEF7	intermediate	
FGF22	intermediate	
CSF2	intermediate	
FGF2	intermediate	
FGF5	intermediate	
EREG	intermediate	
FGF3	intermediate	
FGF1	intermediate	
FGF19	intermediate	
KDR	intermediate	
CD59	intermediate	
NDUFA2	intermediate	
SMAD3	intermediate	
SMAD2	intermediate	
TGFBR2	intermediate	
TIMP2	intermediate	
MMP14	intermediate	
RAF1	intermediate	
SERPINA1	intermediate	
F5	intermediate	
ATP5J	intermediate	
SEC24D	intermediate	
F8	intermediate	
HADH	intermediate	
CD36	intermediate	
