Hydrochlorothiazide	drug	
SLC22A6	drug_target	
CA1	drug_target	
CA2	drug_target	
CA4	drug_target	
KCNMA1	drug_target	
SLC12A3	drug_target	
CA9	drug_target	
CA12	drug_target	
Peripheral neuropathy, myopathy, hoarseness, and hearing loss	phenotype	
Erlotinib	drug	
EGFR	drug_target	
CYP1A2	drug_target	
CYP2D6	drug_target	
ABCB1	drug_target	
CYP3A4	drug_target	
ALB	drug_target	
CYP3A5	drug_target	
CYP2C8	drug_target	
ABCG2	drug_target	
CYP1B1	drug_target	
CYP1A1	drug_target	
NR1I2	drug_target	
UGT1A1	drug_target	
ORM1	drug_target	
Myofibrillar myopathy, BAG3-related	phenotype	
Myopathy, scapulohumeroperoneal	phenotype	
Zidovudine	drug	
CYP2C9	drug_target	
CYP2C19	drug_target	
SLC22A2	drug_target	
SLC22A8	drug_target	
ABCC4	drug_target	
ABCC5	drug_target	
SLC22A11	drug_target	
CYP2A6	drug_target	
UGT2B7	drug_target	
TK1	drug_target	
SLC28A1	drug_target	
SLC29A2	drug_target	
TERT	drug_target	
Prednisone	drug	
SLCO1A2	drug_target	
HSD11B1	drug_target	
NR3C1	drug_target	
Fosphenytoin	drug	
CYP2B6	drug_target	
SCN5A	drug_target	
Phenytoin	drug	
ABCC2	drug_target	
CYP2C18	drug_target	
SCN1A	drug_target	
SLCO1C1	drug_target	
Rosuvastatin	drug	
ABCB11	drug_target	
ABCC1	drug_target	
SLCO1B1	drug_target	
SLC7A11	drug_target	
HMGCR	drug_target	
SLCO2B1	drug_target	
SLCO1B3	drug_target	
Acitretin	drug	
RBP1	drug_target	
CYP26A1	drug_target	
RARG	drug_target	
RARB	drug_target	
RXRG	drug_target	
RXRB	drug_target	
RARA	drug_target	
RXRA	drug_target	
Clomipramine	drug	
GSTP1	drug_target	
SLC6A4	drug_target	
SLC6A2	drug_target	
HTR2C	drug_target	
HTR2B	drug_target	
HTR2A	drug_target	
Niacin	drug	
SLC16A3	drug_target	
SLC16A1	drug_target	
SLC22A5	drug_target	
HCAR3	drug_target	
HCAR2	drug_target	
QPRT	drug_target	
NNMT	drug_target	
SLC5A8	drug_target	
Inclusion Body Myopathy, Sporadic	phenotype	
Prilocaine	drug	
Ziprasidone	drug	
DRD2	drug_target	
CHRM3	drug_target	
CHRM1	drug_target	
CHRM2	drug_target	
ADRA1A	drug_target	
ADRA1B	drug_target	
HRH1	drug_target	
HTR1D	drug_target	
HTR1B	drug_target	
HTR1A	drug_target	
HTR1E	drug_target	
HTR7	drug_target	
DRD1	drug_target	
DRD5	drug_target	
DRD3	drug_target	
DRD4	drug_target	
HTR3A	drug_target	
HTR6	drug_target	
ADRA2A	drug_target	
ADRA2B	drug_target	
ADRA2C	drug_target	
CHRM4	drug_target	
CHRM5	drug_target	
Saquinavir	drug	
SLC22A1	drug_target	
CYP11A1	drug_target	
Abiraterone	drug	
CYP17A1	drug_target	
SULT2A1	drug_target	
Fluoxetine	drug	
Rocuronium	drug	
CHRNA2	drug_target	
Lidocaine	drug	
SCN10A	drug_target	
Imatinib	drug	
PTGS1	drug_target	
PDGFRB	drug_target	
PDGFRA	drug_target	
ABL1	drug_target	
NTRK1	drug_target	
KIT	drug_target	
CSF1R	drug_target	
DDR1	drug_target	
ABCA3	drug_target	
complex:lAo9+jzjVOaRJSWZQvoh0G1mUDc	intermediate	
SETX	intermediate	
NLRC4	intermediate	
SPAST	intermediate	
GJC2	intermediate	
APOE	intermediate	
SACS	intermediate	
GSN	intermediate	
GFAP	intermediate	
SERPING1	intermediate	
LDB3	intermediate	
TLN2	intermediate	
CFH	intermediate	
TTN	intermediate	
LAT	intermediate	
DMD	intermediate	
FN1	intermediate	
HRAS	intermediate	
NCAM1	intermediate	
CHKB	intermediate	
DNM2	intermediate	
SPTB	intermediate	
RET	intermediate	
MGST1	intermediate	
SPTBN4	intermediate	
AGFG1	intermediate	
RYR2	intermediate	
TRAPPC11	intermediate	
OBSL1	intermediate	
BIN1	intermediate	
ACTN2	intermediate	
TTR	intermediate	
SPTAN1	intermediate	
AMPH	intermediate	
MGST3	intermediate	
MGST2	intermediate	
CRABP2	intermediate	
NCOA3	intermediate	
PPARG	intermediate	
CXCL9	intermediate	
CXCL11	intermediate	
CXCR3	intermediate	
CXCL10	intermediate	
NMUR1	intermediate	
CCR6	intermediate	
TAS2R40	intermediate	
CCR3	intermediate	
CCR5	intermediate	
HTR1F	intermediate	
TAS2R20	intermediate	
BDKRB2	intermediate	
LPAR1	intermediate	
P2RY11	intermediate	
S1PR1	intermediate	
NPBWR1	intermediate	
GPR17	intermediate	
APP	intermediate	
NPY4R	intermediate	
GABBR2	intermediate	
TAS2R16	intermediate	
TAS2R60	intermediate	
CCL21	intermediate	
FPR2	intermediate	
GNG2	intermediate	
NMU	intermediate	
FPR1	intermediate	
GPR55	intermediate	
GRM2	intermediate	
NPB	intermediate	
HEBP1	intermediate	
PDYN	intermediate	
CXCR4	intermediate	
CCL5	intermediate	
C3	intermediate	
CST3	intermediate	
CCL16	intermediate	
HTR5A	intermediate	
OPRK1	intermediate	
CCL23	intermediate	
TAS2R7	intermediate	
TAS2R43	intermediate	
TAS2R4	intermediate	
GRM8	intermediate	
CCR1	intermediate	
SUCNR1	intermediate	
GCG	intermediate	
NMS	intermediate	
TAS2R8	intermediate	
S1PR2	intermediate	
PPY	intermediate	
UBB	intermediate	
SSTR5	intermediate	
CXCL5	intermediate	
RXFP4	intermediate	
CXCR1	intermediate	
S1PR5	intermediate	
PPBP	intermediate	
TAS2R41	intermediate	
C5	intermediate	
PF4	intermediate	
GPR18	intermediate	
CXCL3	intermediate	
TAS2R45	intermediate	
CASR	intermediate	
TAS2R46	intermediate	
CXCL6	intermediate	
SSTR4	intermediate	
TAS2R50	intermediate	
NPY2R	intermediate	
CNR2	intermediate	
CXCR2	intermediate	
P2RY13	intermediate	
CXCR5	intermediate	
CXCL13	intermediate	
KNG1	intermediate	
GRM6	intermediate	
CCL28	intermediate	
LPAR2	intermediate	
CCR2	intermediate	
C5AR1	intermediate	
INSL5	intermediate	
ADORA3	intermediate	
HRH3	intermediate	
GRM4	intermediate	
MT-RNR2	intermediate	
CXCL16	intermediate	
OPRL1	intermediate	
APLNR	intermediate	
TAS2R9	intermediate	
NPBWR2	intermediate	
POMC	intermediate	
P2RY4	intermediate	
PMCH	intermediate	
CCR7	intermediate	
MCHR1	intermediate	
GNAI1	intermediate	
GALR3	intermediate	
TAS2R31	intermediate	
TAS2R19	intermediate	
FPR3	intermediate	
ANXA1	intermediate	
GNAT3	intermediate	
NPY1R	intermediate	
GNB1	intermediate	
CXCL8	intermediate	
GNAI3	intermediate	
AGTR2	intermediate	
S1PR4	intermediate	
PNOC	intermediate	
TAS2R3	intermediate	
TAS2R1	intermediate	
TAS2R14	intermediate	
ADORA1	intermediate	
AGT	intermediate	
MCHR2	intermediate	
TAS2R10	intermediate	
NPY	intermediate	
NPS	intermediate	
PTGER3	intermediate	
CCR10	intermediate	
RLN3	intermediate	
OXER1	intermediate	
PENK	intermediate	
CXCL1	intermediate	
GALR2	intermediate	
P2RY12	intermediate	
LPAR5	intermediate	
CXCR6	intermediate	
CCR8	intermediate	
LPAR3	intermediate	
NPY5R	intermediate	
SAA1	intermediate	
GAL	intermediate	
S1PR3	intermediate	
C3AR1	intermediate	
TAS2R39	intermediate	
SSTR1	intermediate	
CORT	intermediate	
SSTR3	intermediate	
TAS2R38	intermediate	
SSTR2	intermediate	
CCL20	intermediate	
GALR1	intermediate	
CXCL2	intermediate	
MTNR1B	intermediate	
PYY	intermediate	
OXGR1	intermediate	
ACKR3	intermediate	
TAS2R5	intermediate	
HCAR1	intermediate	
TAS2R30	intermediate	
CXCL12	intermediate	
BDKRB1	intermediate	
GCGR	intermediate	
P2RY14	intermediate	
RXFP3	intermediate	
PTGDR2	intermediate	
MTNR1A	intermediate	
GPER1	intermediate	
APLN	intermediate	
NPSR1	intermediate	
OPRD1	intermediate	
GNAI2	intermediate	
NMUR2	intermediate	
GRM7	intermediate	
GABBR1	intermediate	
HRH4	intermediate	
SST	intermediate	
TAS2R42	intermediate	
CCR4	intermediate	
CCL27	intermediate	
CCR9	intermediate	
CCL25	intermediate	
NPW	intermediate	
CCL19	intermediate	
CNR1	intermediate	
rs429358	intermediate	
TOMM40	intermediate	
APOC1	intermediate	
MED9	intermediate	
MED25	intermediate	
ATM	intermediate	
APOB	intermediate	
ERBB2	intermediate	
SPTBN2	intermediate	
PIK3CA	intermediate	
GFRA1	intermediate	
GDNF	intermediate	
NEFL	intermediate	
FGFR4	intermediate	
EGF	intermediate	
KRAS	intermediate	
ARTN	intermediate	
CSF2	intermediate	
ADRB2	intermediate	
IL3	intermediate	
IL2	intermediate	
RASGRP1	intermediate	
JAK2	intermediate	
HGF	intermediate	
