Dasatinib	drug	
CYP1A2	drug_target	
ABCB1	drug_target	
CYP3A4	drug_target	
CYP3A5	drug_target	
ABCG2	drug_target	
PDGFRB	drug_target	
CYP1B1	drug_target	
CYP1A1	drug_target	
ABL2	drug_target	
ABL1	drug_target	
FMO3	drug_target	
KIT	drug_target	
SRC	drug_target	
EPHA2	drug_target	
LCK	drug_target	
YES1	drug_target	
STAT5B	drug_target	
FYN	drug_target	
Pancreatitis	phenotype	
Fosinopril	drug	
ACE	drug_target	
SLC15A2	drug_target	
Acute pancreatitis	phenotype	
Trandolapril	drug	
CES1	drug_target	
Propofol	drug	
CYP2D6	drug_target	
CYP2E1	drug_target	
CYP2C9	drug_target	
UGT1A9	drug_target	
ALB	drug_target	
CYP2C18	drug_target	
CYP2C19	drug_target	
CYP2C8	drug_target	
CYP2B6	drug_target	
CYP2A6	drug_target	
UGT1A1	drug_target	
UGT1A6	drug_target	
UGT1A8	drug_target	
GABRB2	drug_target	
GABRB3	drug_target	
FAAH	drug_target	
SCN2A	drug_target	
SCN4A	drug_target	
Pancreatitis, Alcoholic	phenotype	
Ketoprofen	drug	
PTGS2	drug_target	
PTGS1	drug_target	
SLCO1A2	drug_target	
SLC22A6	drug_target	
SLC22A8	drug_target	
ABCC4	drug_target	
SLC22A11	drug_target	
CXCR1	drug_target	
Menthol	drug	
OPRK1	drug_target	
TRPM8	drug_target	
Hereditary pancreatitis	phenotype	
Paroxetine	drug	
SLC6A4	drug_target	
SLC6A2	drug_target	
CHRM3	drug_target	
CHRM1	drug_target	
CHRM2	drug_target	
HTR2A	drug_target	
CHRM4	drug_target	
CHRM5	drug_target	
Lanreotide	drug	
SSTR5	drug_target	
SSTR2	drug_target	
Atenolol	drug	
ADRB1	drug_target	
ADRB2	drug_target	
Propranolol	drug	
SLC22A2	drug_target	
HTR1B	drug_target	
HTR1A	drug_target	
ORM1	drug_target	
ADRB3	drug_target	
Danazol	drug	
GNRHR	drug_target	
CYP19A1	drug_target	
ESR1	drug_target	
PGR	drug_target	
AR	drug_target	
SHBG	drug_target	
CCL2	drug_target	
Octreotide	drug	
MPO	drug_target	
SSTR1	drug_target	
Diphenoxylate	drug	
OPRM1	drug_target	
OPRD1	drug_target	
Oxaliplatin	drug	
ABCC2	drug_target	
SLC22A1	drug_target	
SLC22A3	drug_target	
GSTM1	drug_target	
GSTP1	drug_target	
GSTT1	drug_target	
NQO1	drug_target	
SOD1	drug_target	
MT1A	drug_target	
MT2A	drug_target	
SLC31A1	drug_target	
ATP7B	drug_target	
ATP7A	drug_target	
Risperidone	drug	
DRD2	drug_target	
HTR2C	drug_target	
ADRA1A	drug_target	
ADRA1B	drug_target	
HRH1	drug_target	
HTR1D	drug_target	
DRD1	drug_target	
DRD3	drug_target	
DRD4	drug_target	
ADRA2A	drug_target	
ADRA2B	drug_target	
ADRA2C	drug_target	
Losartan	drug	
AGTR1	drug_target	
UGT1A3	drug_target	
UGT1A10	drug_target	
UGT2B7	drug_target	
SLC22A12	drug_target	
Ropinirole	drug	
HTR2B	drug_target	
DRD5	drug_target	
Naltrexone	drug	
Sulindac	drug	
AKR1B1	drug_target	
PPARD	drug_target	
PTGDR2	drug_target	
MAPK3	drug_target	
Pilocarpine	drug	
Naloxone	drug	
CREB1	drug_target	
TLR4	drug_target	
Candesartan	drug	
Gabapentin	drug	
BCAT1	drug_target	
ADORA1	drug_target	
CACNA2D1	drug_target	
CACNA2D2	drug_target	
CACNA1B	drug_target	
Citalopram	drug	
SLC6A3	drug_target	
Pasireotide	drug	
SSTR3	drug_target	
Valsartan	drug	
SLCO1B1	drug_target	
SLCO1B3	drug_target	
Riluzole	drug	
SLC7A11	drug_target	
SCN5A	drug_target	
Thalidomide	drug	
TNF	drug_target	
FGFR2	drug_target	
CRBN	drug_target	
NFKB1	drug_target	
Pergolide	drug	
ADRA1D	drug_target	
Quinapril	drug	
Pramipexole	drug	
Enalapril	drug	
Blinatumomab	drug	
CD3D	drug_target	
CD19	drug_target	
Amoxapine	drug	
HTR7	drug_target	
GABRA1	drug_target	
HTR3A	drug_target	
HTR6	drug_target	
HRH4	drug_target	
Enalaprilat	drug	
Capsaicin	drug	
GLUL	drug_target	
BCHE	drug_target	
DBH	drug_target	
TRPV1	drug_target	
MAOA	drug_target	
Nintedanib	drug	
FGFR1	drug_target	
FGFR3	drug_target	
FLT4	drug_target	
KDR	drug_target	
FLT3	drug_target	
FLT1	drug_target	
LYN	drug_target	
Hydrochlorothiazide	drug	
CA1	drug_target	
CA2	drug_target	
CA4	drug_target	
KCNMA1	drug_target	
SLC12A3	drug_target	
CA9	drug_target	
CA12	drug_target	
Atropine	drug	
Droxidopa	drug	
DDC	drug_target	
SLC16A10	drug_target	
PAH	drug_target	
Busulfan	drug	
GSTA1	drug_target	
GSTA2	drug_target	
MGST2	drug_target	
Morphine	drug	
UGT2B15	drug_target	
UGT2B4	drug_target	
Clozapine	drug	
UGT1A4	drug_target	
HTR1E	drug_target	
CALY	drug_target	
Acamprosate	drug	
GRM5	drug_target	
Caffeine	drug	
PDE4B	drug_target	
ADORA2A	drug_target	
RYR1	drug_target	
PRKDC	drug_target	
PIK3CD	drug_target	
PIK3CA	drug_target	
PIK3CB	drug_target	
ATM	drug_target	
Telmisartan	drug	
PPARG	drug_target	
Prazosin	drug	
KCNH2	drug_target	
KCNH6	drug_target	
KCNH7	drug_target	
Dexamethasone	drug	
CYP4A11	drug_target	
ABCB11	drug_target	
NOS2	drug_target	
CYP17A1	drug_target	
CYP11A1	drug_target	
NR3C1	drug_target	
ANXA1	drug_target	
CYP3A43	drug_target	
NR0B1	drug_target	
Erlotinib	drug	
EGFR	drug_target	
NR1I2	drug_target	
Eprosartan	drug	
Quetiapine	drug	
Olanzapine	drug	
HRH2	drug_target	
HTR5A	drug_target	
Clonidine	drug	
SLC22A5	drug_target	
SLC22A4	drug_target	
Levodopa	drug	
SLC7A8	drug_target	
SLC7A5	drug_target	
Estradiol	drug	
ABCC10	drug_target	
SLCO2B1	drug_target	
SLCO1C1	drug_target	
ESR2	drug_target	
SLCO4A1	drug_target	
FABP2	drug_target	
Estrone	drug	
Aripiprazole	drug	
Donepezil	drug	
ACHE	drug_target	
Nadolol	drug	
Erythromycin	drug	
MLNR	drug_target	
Mirtazapine	drug	
HRH3	drug_target	
Prilocaine	drug	
Fenoprofen	drug	
Tenecteplase	drug	
PLG	drug_target	
FGA	drug_target	
PLAUR	drug_target	
SERPINE1	drug_target	
SERPINB2	drug_target	
CALR	drug_target	
CANX	drug_target	
LRP1	drug_target	
CLEC3B	drug_target	
KRT8	drug_target	
ANXA2	drug_target	
Memantine	drug	
GRIN1	drug_target	
GRIN2A	drug_target	
GRIN2B	drug_target	
GRIN3A	drug_target	
Vandetanib	drug	
ABCC1	drug_target	
VEGFA	drug_target	
FMO1	drug_target	
TEK	drug_target	
PTK6	drug_target	
Ramipril	drug	
Aliskiren	drug	
REN	drug_target	
Lisinopril	drug	
ACE2	drug_target	
Tramadol	drug	
Benazepril	drug	
MTHFR	drug_target	
Olmesartan	drug	
Isopropyl Alcohol	drug	
RNASE1	drug_target	
PLA2G2A	drug_target	
PRSS2	drug_target	
GM2A	drug_target	
RNGTT	drug_target	
ADI1	drug_target	
GCH1	drug_target	
GDF5	drug_target	
DCXR	drug_target	
PRDX6	drug_target	
ACP5	drug_target	
AHCY	drug_target	
DDX39B	drug_target	
Sulfasalazine	drug	
SLC46A1	drug_target	
ALOX5	drug_target	
CHUK	drug_target	
IKBKB	drug_target	
ACAT1	drug_target	
TBXAS1	drug_target	
PLA2G1B	drug_target	
Pancreatitis, Acute Necrotizing	phenotype	
Ibuprofen	drug	
PLAT	drug_target	
THBD	drug_target	
CFTR	drug_target	
BCL2	drug_target	
Pentazocine	drug	
SIGMAR1	drug_target	
Ponatinib	drug	
FGFR4	drug_target	
PDGFRA	drug_target	
RET	drug_target	
BCR	drug_target	
Acetaminophen	drug	
NAT2	drug_target	
SULT1A1	drug_target	
SULT1E1	drug_target	
SULT2A1	drug_target	
Diclofenac	drug	
TTR	drug_target	
KCNQ2	drug_target	
KCNQ3	drug_target	
ASIC1	drug_target	
Hydroflumethiazide	drug	
ATP1A1	drug_target	
FGF16	intermediate	
HRAS	intermediate	
HLA-DRB1	intermediate	
NCK1	intermediate	
FGF8	intermediate	
NRG1	intermediate	
HLA-DQA1	intermediate	
HBEGF	intermediate	
MET	intermediate	
PTPN22	intermediate	
ERBB2	intermediate	
ERBB4	intermediate	
FGF23	intermediate	
SHC1	intermediate	
KLB	intermediate	
FGF18	intermediate	
FGB	intermediate	
NRG4	intermediate	
FGF4	intermediate	
HLA-DQB1	intermediate	
PDGFA	intermediate	
CD4	intermediate	
SOS1	intermediate	
FGF7	intermediate	
FGF17	intermediate	
GRB7	intermediate	
KITLG	intermediate	
KRAS	intermediate	
HLA-DPB1	intermediate	
FGF22	intermediate	
FGF2	intermediate	
FGF5	intermediate	
PTPN11	intermediate	
FRS2	intermediate	
JAK2	intermediate	
PDGFB	intermediate	
IL2RA	intermediate	
EREG	intermediate	
HLA-E	intermediate	
HLA-DQA2	intermediate	
PIK3R2	intermediate	
FGG	intermediate	
FGF3	intermediate	
FGF1	intermediate	
HGF	intermediate	
FGF19	intermediate	
CDC42	intermediate	
PIK3R1	intermediate	
GRB2	intermediate	
FGF20	intermediate	
FGF10	intermediate	
KL	intermediate	
FGF9	intermediate	
BTC	intermediate	
FGF6	intermediate	
AGT	intermediate	
complex:lAo9+jzjVOaRJSWZQvoh0G1mUDc	intermediate	
rs2070959	intermediate	
UGT1A7	intermediate	
APOE	intermediate	
rs8330	intermediate	
rs6759892	intermediate	
GALR2	intermediate	
PPBP	intermediate	
GABBR1	intermediate	
GAL	intermediate	
CXCL8	intermediate	
GALR3	intermediate	
PRSS3	intermediate	
CCL5	intermediate	
CNR1	intermediate	
PPY	intermediate	
CNR2	intermediate	
BDKRB2	intermediate	
CASR	intermediate	
SST	intermediate	
CCR1	intermediate	
CCR6	intermediate	
CCL20	intermediate	
CFB	intermediate	
KLK3	intermediate	
CXCR3	intermediate	
CXCL6	intermediate	
TSC22D1	intermediate	
CXCL12	intermediate	
APOC2	intermediate	
TP53	intermediate	
CXCR2	intermediate	
PLAG1	intermediate	
HP	intermediate	
CXCL10	intermediate	
CXCR4	intermediate	
GNAI2	intermediate	
CCL28	intermediate	
CXCL1	intermediate	
CXCL5	intermediate	
NMUR1	intermediate	
TAS2R40	intermediate	
CCR3	intermediate	
CCR5	intermediate	
HTR1F	intermediate	
TAS2R20	intermediate	
LPAR1	intermediate	
EDN1	intermediate	
S1PR1	intermediate	
NPBWR1	intermediate	
GPR17	intermediate	
APP	intermediate	
NPY4R	intermediate	
GABBR2	intermediate	
TAS2R16	intermediate	
TAS2R60	intermediate	
CCL21	intermediate	
FPR2	intermediate	
GNG2	intermediate	
NMU	intermediate	
GPR55	intermediate	
FPR1	intermediate	
GRM2	intermediate	
NPB	intermediate	
HEBP1	intermediate	
PDYN	intermediate	
GHRL	intermediate	
C3	intermediate	
CCL16	intermediate	
CCL23	intermediate	
TAS2R43	intermediate	
GRM8	intermediate	
TAS2R7	intermediate	
TAS2R4	intermediate	
SUCNR1	intermediate	
NMS	intermediate	
TAS2R8	intermediate	
TF	intermediate	
S1PR2	intermediate	
RXFP4	intermediate	
S1PR5	intermediate	
TAS2R41	intermediate	
C5	intermediate	
AP2S1	intermediate	
PF4	intermediate	
GPR18	intermediate	
TACR1	intermediate	
CXCL3	intermediate	
TAS2R45	intermediate	
CXCL11	intermediate	
TAS2R46	intermediate	
SSTR4	intermediate	
TAS2R50	intermediate	
NPY2R	intermediate	
CXCR5	intermediate	
P2RY13	intermediate	
CXCL13	intermediate	
KNG1	intermediate	
GRM6	intermediate	
LPAR2	intermediate	
CCR2	intermediate	
C5AR1	intermediate	
INSL5	intermediate	
ADORA3	intermediate	
GRM4	intermediate	
MT-RNR2	intermediate	
CXCL16	intermediate	
OPRL1	intermediate	
APLNR	intermediate	
TAS2R9	intermediate	
NPBWR2	intermediate	
POMC	intermediate	
P2RY4	intermediate	
PMCH	intermediate	
CCR7	intermediate	
MCHR1	intermediate	
GNAI1	intermediate	
HCAR2	intermediate	
HCAR3	intermediate	
TAS2R31	intermediate	
TAS2R19	intermediate	
CXCL9	intermediate	
FPR3	intermediate	
GNAT3	intermediate	
NPY1R	intermediate	
GNB1	intermediate	
GNAI3	intermediate	
AGTR2	intermediate	
S1PR4	intermediate	
PNOC	intermediate	
TAS2R3	intermediate	
TAS2R1	intermediate	
TAS2R14	intermediate	
MCHR2	intermediate	
TAS2R10	intermediate	
NPY	intermediate	
PTGER3	intermediate	
CCR10	intermediate	
RLN3	intermediate	
OXER1	intermediate	
EDNRA	intermediate	
PENK	intermediate	
LPAR5	intermediate	
P2RY12	intermediate	
CXCR6	intermediate	
CCR8	intermediate	
LPAR3	intermediate	
SAA1	intermediate	
NPY5R	intermediate	
C3AR1	intermediate	
S1PR3	intermediate	
TAS2R39	intermediate	
CORT	intermediate	
TAS2R38	intermediate	
GALR1	intermediate	
CXCL2	intermediate	
CCK	intermediate	
PYY	intermediate	
MTNR1B	intermediate	
OXGR1	intermediate	
ACKR3	intermediate	
TAS2R5	intermediate	
HCAR1	intermediate	
TAS2R30	intermediate	
BDKRB1	intermediate	
P2RY14	intermediate	
RXFP3	intermediate	
MTNR1A	intermediate	
GPER1	intermediate	
APLN	intermediate	
NMUR2	intermediate	
GRM7	intermediate	
TAS2R42	intermediate	
CCR4	intermediate	
CCL27	intermediate	
CCR9	intermediate	
CCL25	intermediate	
NPW	intermediate	
CCL19	intermediate	
GCG	intermediate	
PTHLH	intermediate	
ADM	intermediate	
EGF	intermediate	
GIP	intermediate	
SYT1	intermediate	
SCT	intermediate	
ADCYAP1	intermediate	
MGST1	intermediate	
P2RY6	intermediate	
CCKBR	intermediate	
F2RL1	intermediate	
NTS	intermediate	
GAST	intermediate	
TACR3	intermediate	
TAC1	intermediate	
NTSR1	intermediate	
TACR2	intermediate	
SLC25A13	intermediate	
FFAR1	intermediate	
P2RY11	intermediate	
PTAFR	intermediate	
PTGER1	intermediate	
GPR65	intermediate	
FFAR2	intermediate	
NPFFR2	intermediate	
PROK2	intermediate	
HCRT	intermediate	
OXTR	intermediate	
PROKR1	intermediate	
QRFP	intermediate	
AVPR1A	intermediate	
CYSLTR1	intermediate	
NPFFR1	intermediate	
PROK1	intermediate	
TRHR	intermediate	
GRM1	intermediate	
NMB	intermediate	
FFAR3	intermediate	
XCL2	intermediate	
EDN3	intermediate	
GNA15	intermediate	
GPR4	intermediate	
EDNRB	intermediate	
GHSR	intermediate	
UTS2R	intermediate	
F2RL3	intermediate	
GPRC6A	intermediate	
CALCA	intermediate	
OXT	intermediate	
LPAR6	intermediate	
GNRHR2	intermediate	
NCOA3	intermediate	
GPR68	intermediate	
CTSL	intermediate	
TRH	intermediate	
PTGFR	intermediate	
P2RY1	intermediate	
KISS1	intermediate	
AVPR1B	intermediate	
P2RY10	intermediate	
F2R	intermediate	
XCR1	intermediate	
LTB4R	intermediate	
UTS2	intermediate	
KISS1R	intermediate	
PROKR2	intermediate	
NTSR2	intermediate	
NPS	intermediate	
HCRTR2	intermediate	
F2	intermediate	
GNAQ	intermediate	
XCL1	intermediate	
NMBR	intermediate	
LTB4R2	intermediate	
OPN4	intermediate	
GRP	intermediate	
GNRH2	intermediate	
EDN2	intermediate	
UTS2B	intermediate	
GNA11	intermediate	
GNRH1	intermediate	
GCGR	intermediate	
CYSLTR2	intermediate	
GNA14	intermediate	
NPSR1	intermediate	
QRFPR	intermediate	
MLN	intermediate	
CCKAR	intermediate	
GRPR	intermediate	
HCRTR1	intermediate	
GPR132	intermediate	
NPFF	intermediate	
LPAR4	intermediate	
TAC3	intermediate	
P2RY2	intermediate	
F2RL2	intermediate	
BRAF	intermediate	
CD14	intermediate	
MYD88	intermediate	
TLR3	intermediate	
PTGDR	intermediate	
NOD2	intermediate	
PSPN	intermediate	
LTA	intermediate	
rs1800629	intermediate	
NFKBIA	intermediate	
PLCG1	intermediate	
LAT	intermediate	
PTK2	intermediate	
HSP90AA1	intermediate	
TLR6	intermediate	
RELA	intermediate	
DERL1	intermediate	
CRK	intermediate	
