Hydrochlorothiazide	drug	
SLC22A6	drug_target	
CA1	drug_target	
CA2	drug_target	
CA4	drug_target	
KCNMA1	drug_target	
SLC12A3	drug_target	
CA9	drug_target	
CA12	drug_target	
Peripheral neuropathy, myopathy, hoarseness, and hearing loss	phenotype	
Tetracycline	drug	
CYP3A4	drug_target	
ALB	drug_target	
SLC22A8	drug_target	
PADI4	drug_target	
SLC22A11	drug_target	
PRNP	drug_target	
Peripheral axonal neuropathy	phenotype	
Sulfamethizole	drug	
CYP2C9	drug_target	
Hyaluronidase	drug	
TGFB1	drug_target	
Insulin Detemir	drug	
CYP1A2	drug_target	
INSR	drug_target	
Trastuzumab	drug	
EGFR	drug_target	
FCGR3B	drug_target	
C1R	drug_target	
C1QA	drug_target	
C1QB	drug_target	
C1QC	drug_target	
FCGR3A	drug_target	
C1S	drug_target	
FCGR1A	drug_target	
FCGR2A	drug_target	
FCGR2B	drug_target	
FCGR2C	drug_target	
ERBB2	drug_target	
CYP19A1	drug_target	
Trastuzumab emtansine	drug	
ABCB1	drug_target	
CYP3A5	drug_target	
Prilocaine	drug	
SCN5A	drug_target	
Probenecid	drug	
ABCC2	drug_target	
CYP2C19	drug_target	
CYP2C8	drug_target	
ABCC3	drug_target	
ABCC1	drug_target	
SLCO1A2	drug_target	
SLC10A1	drug_target	
SLC16A7	drug_target	
SLC16A1	drug_target	
SLC22A2	drug_target	
SLC22A1	drug_target	
SLC22A5	drug_target	
ABCC4	drug_target	
ABCC5	drug_target	
ABCC11	drug_target	
SLCO1C1	drug_target	
ABCC6	drug_target	
SLC22A12	drug_target	
PANX1	drug_target	
Choline	drug	
BCHE	drug_target	
PCYT1B	drug_target	
ACHE	drug_target	
PCYT1A	drug_target	
PLD2	drug_target	
PLD1	drug_target	
PHOSPHO1	drug_target	
CEPT1	drug_target	
CHKB	drug_target	
CHAT	drug_target	
CHKA	drug_target	
CHDH	drug_target	
SLC22A3	drug_target	
SLC22A4	drug_target	
SLC44A1	drug_target	
SLC44A4	drug_target	
SLC44A2	drug_target	
SLC44A3	drug_target	
SLC5A7	drug_target	
Olaparib	drug	
CYP2B6	drug_target	
PARP1	drug_target	
PARP2	drug_target	
PARP3	drug_target	
Tacrolimus	drug	
ORM1	drug_target	
FKBP1A	drug_target	
ABCA5	drug_target	
Vemurafenib	drug	
CYP2D6	drug_target	
ABCG2	drug_target	
BRAF	drug_target	
Insulin Lispro	drug	
IGF1R	drug_target	
Acitretin	drug	
RBP1	drug_target	
CYP26A1	drug_target	
RARG	drug_target	
RARB	drug_target	
RXRG	drug_target	
RXRB	drug_target	
RARA	drug_target	
RXRA	drug_target	
Zonisamide	drug	
MAOA	drug_target	
AOX1	drug_target	
MAOB	drug_target	
SCN1A	drug_target	
CACNA1H	drug_target	
CA7	drug_target	
CACNA1G	drug_target	
SCN2A	drug_target	
CACNA1I	drug_target	
SCN4A	drug_target	
CA14	drug_target	
CA3	drug_target	
SCN3A	drug_target	
SCN1B	drug_target	
SCN4B	drug_target	
CA5A	drug_target	
CA5B	drug_target	
CA6	drug_target	
CA8	drug_target	
CA10	drug_target	
CA13	drug_target	
Indomethacin	drug	
PTGS2	drug_target	
PTGS1	drug_target	
UGT1A9	drug_target	
GLO1	drug_target	
PPARG	drug_target	
UGT1A1	drug_target	
UGT2B7	drug_target	
CES1	drug_target	
PLA2G2A	drug_target	
PTGR2	drug_target	
PTGDR2	drug_target	
PPARA	drug_target	
Sulindac	drug	
AKR1B1	drug_target	
PPARD	drug_target	
CYP1A1	drug_target	
MAPK3	drug_target	
Riluzole	drug	
SLC7A11	drug_target	
Insulin Glargine	drug	
Erlotinib	drug	
CYP1B1	drug_target	
NR1I2	drug_target	
Lidocaine	drug	
CYP2C18	drug_target	
CYP2A6	drug_target	
SCN10A	drug_target	
Pertuzumab	drug	
complex:lAo9+jzjVOaRJSWZQvoh0G1mUDc	intermediate	
SETX	intermediate	
NLRC4	intermediate	
SPAST	intermediate	
GJC2	intermediate	
APOE	intermediate	
SACS	intermediate	
GSN	intermediate	
GFAP	intermediate	
SERPING1	intermediate	
LDB3	intermediate	
TLN2	intermediate	
TTR	intermediate	
INS	intermediate	
ATM	intermediate	
APOB	intermediate	
SPTBN2	intermediate	
DNM2	intermediate	
PIK3CA	intermediate	
ICOS	intermediate	
GFRA1	intermediate	
GDNF	intermediate	
NEFL	intermediate	
RET	intermediate	
FGFR4	intermediate	
EGF	intermediate	
CD3G	intermediate	
KRAS	intermediate	
ARTN	intermediate	
IGHG1	intermediate	
ADRB2	intermediate	
CSF2	intermediate	
IL3	intermediate	
IL2	intermediate	
JAK2	intermediate	
RASGRP1	intermediate	
HGF	intermediate	
GTF2H1	intermediate	
DDB2	intermediate	
CUL4B	intermediate	
ERCC4	intermediate	
XPA	intermediate	
ERCC3	intermediate	
XPC	intermediate	
ERCC2	intermediate	
TGFBR2	intermediate	
SMAD3	intermediate	
IGF2	intermediate	
IGF1	intermediate	
IRS1	intermediate	
IRS2	intermediate	
CRABP2	intermediate	
MED9	intermediate	
NCOA3	intermediate	
MED25	intermediate	
APP	intermediate	
HDAC3	intermediate	
MED1	intermediate	
TP53	intermediate	
NCOR2	intermediate	
NCOR1	intermediate	
PPBP	intermediate	
IL17RD	intermediate	
MAPK1	intermediate	
MGST1	intermediate	
MGST3	intermediate	
LAT	intermediate	
MGST2	intermediate	
