Tinzaparin	drug	
ITGA4	drug_target	
SERPINC1	drug_target	
CXCL12	drug_target	
ADAMTS4	drug_target	
Pneumocystis jiroveci pneumonia	phenotype	
Amantadine	drug	
ABCB1	drug_target	
DDC	drug_target	
SLC22A2	drug_target	
SLC22A1	drug_target	
GRIN3A	drug_target	
DRD2	drug_target	
MAOB	drug_target	
Streptococcal pneumonia	phenotype	
Prochlorperazine	drug	
CYP2D6	drug_target	
CYP3A4	drug_target	
Loxapine	drug	
SLC6A4	drug_target	
SLC6A3	drug_target	
SLC6A2	drug_target	
CHRM3	drug_target	
CHRM1	drug_target	
ADRB1	drug_target	
HTR2C	drug_target	
CHRM2	drug_target	
ADRA1A	drug_target	
ADRA1B	drug_target	
HRH1	drug_target	
HTR1D	drug_target	
HTR1B	drug_target	
HTR1A	drug_target	
HTR1E	drug_target	
HTR7	drug_target	
HTR2A	drug_target	
DRD1	drug_target	
DRD5	drug_target	
DRD3	drug_target	
DRD4	drug_target	
HTR3A	drug_target	
HTR6	drug_target	
ADRA2A	drug_target	
ADRA2B	drug_target	
ADRA2C	drug_target	
CHRM4	drug_target	
CHRM5	drug_target	
HRH2	drug_target	
HRH4	drug_target	
HTR5A	drug_target	
Pneumonia	phenotype	
Levodopa	drug	
SLC16A10	drug_target	
SLC7A8	drug_target	
SLC7A5	drug_target	
Tiotropium	drug	
SLC22A5	drug_target	
SLC22A4	drug_target	
Hydrocodone	drug	
OPRM1	drug_target	
OPRD1	drug_target	
Anakinra	drug	
IL1R1	drug_target	
Pneumonia, Bacterial	phenotype	
Basiliximab	drug	
FCGR3B	drug_target	
C1R	drug_target	
C1QA	drug_target	
C1QB	drug_target	
C1QC	drug_target	
FCGR3A	drug_target	
C1S	drug_target	
FCGR1A	drug_target	
FCGR2A	drug_target	
FCGR2B	drug_target	
FCGR2C	drug_target	
IL2RA	drug_target	
IL2RB	drug_target	
Remifentanil	drug	
OPRK1	drug_target	
Octreotide	drug	
MPO	drug_target	
SSTR1	drug_target	
SSTR5	drug_target	
SSTR2	drug_target	
Mirtazapine	drug	
CYP1A2	drug_target	
CYP2C9	drug_target	
CYP2C8	drug_target	
ADRB2	drug_target	
HTR2B	drug_target	
HRH3	drug_target	
Codeine	drug	
CYP3A5	drug_target	
UGT2B7	drug_target	
UGT2B4	drug_target	
Gabapentin	drug	
BCAT1	drug_target	
ADORA1	drug_target	
CACNA2D1	drug_target	
CACNA2D2	drug_target	
CACNA1B	drug_target	
Promethazine	drug	
CYP2B6	drug_target	
CALM3	drug_target	
Olanzapine	drug	
ALB	drug_target	
CYP2C19	drug_target	
FMO3	drug_target	
ORM1	drug_target	
Sumatriptan	drug	
SLCO1A2	drug_target	
ABCG2	drug_target	
SLCO1B1	drug_target	
MAOA	drug_target	
HTR1F	drug_target	
Infliximab	drug	
TNF	drug_target	
Community acquired pneumonia	phenotype	
Amitriptyline	drug	
CYP2E1	drug_target	
ADRA1D	drug_target	
KCNA1	drug_target	
KCND2	drug_target	
KCND3	drug_target	
NTRK1	drug_target	
NTRK2	drug_target	
KCNQ2	drug_target	
SIGMAR1	drug_target	
KCNQ3	drug_target	
Golimumab	drug	
Ziprasidone	drug	
Tocilizumab	drug	
IL6R	drug_target	
Trihexyphenidyl	drug	
Etanercept	drug	
TNFRSF1B	drug_target	
LTA	drug_target	
PTGS2	drug_target	
Naltrexone	drug	
UGT1A1	drug_target	
Molindone	drug	
Quetiapine	drug	
Zolmitriptan	drug	
Risperidone	drug	
Clozapine	drug	
CYP1B1	drug_target	
CYP1A1	drug_target	
CYP2A6	drug_target	
UGT1A4	drug_target	
CALY	drug_target	
Iloperidone	drug	
Vigabatrin	drug	
GABBR1	drug_target	
Lobar Pneumonia	phenotype	
Aripiprazole	drug	
Tetrabenazine	drug	
SLC18A2	drug_target	
CBR1	drug_target	
Asenapine	drug	
Dexamethasone	drug	
ABCC2	drug_target	
CYP19A1	drug_target	
CYP4A11	drug_target	
ABCB11	drug_target	
NOS2	drug_target	
CYP17A1	drug_target	
CYP11A1	drug_target	
NR3C1	drug_target	
ANXA1	drug_target	
CYP3A43	drug_target	
NR0B1	drug_target	
Aldesleukin	drug	
IL2RG	drug_target	
PLA2G4A	drug_target	
XDH	drug_target	
Maraviroc	drug	
CCR5	drug_target	
Pilocarpine	drug	
Apomorphine	drug	
Trifluoperazine	drug	
TNNC1	drug_target	
S100A4	drug_target	
Tramadol	drug	
Doxepin	drug	
KCNH2	drug_target	
Certolizumab pegol	drug	
Oxymorphone	drug	
Ropinirole	drug	
Paroxetine	drug	
Menthol	drug	
TRPM8	drug_target	
Buprenorphine	drug	
UGT1A9	drug_target	
CYP2C18	drug_target	
Eculizumab	drug	
C5	drug_target	
Fentanyl	drug	
Fluphenazine	drug	
Enalaprilat	drug	
ACE	drug_target	
Clopidogrel	drug	
CES1	drug_target	
P2RY12	drug_target	
Pimozide	drug	
Dextromethorphan	drug	
CHRNA4	drug_target	
CHRNA7	drug_target	
CHRNB2	drug_target	
CHRNA2	drug_target	
CHRNA3	drug_target	
CHRNB4	drug_target	
PGRMC1	drug_target	
Nefazodone	drug	
Balsalazide	drug	
PTGS1	drug_target	
PPARG	drug_target	
ALOX5	drug_target	
Memantine	drug	
GRIN1	drug_target	
GRIN2A	drug_target	
GRIN2B	drug_target	
Treprostinil	drug	
PPARD	drug_target	
PTGIR	drug_target	
Pimavanserin	drug	
Sulfasalazine	drug	
SLC7A11	drug_target	
SLC46A1	drug_target	
CHUK	drug_target	
IKBKB	drug_target	
ACAT1	drug_target	
TBXAS1	drug_target	
PLA2G1B	drug_target	
Perphenazine	drug	
Pramipexole	drug	
Canakinumab	drug	
IL1B	drug_target	
Metoclopramide	drug	
CYP11B2	drug_target	
HTR4	drug_target	
Quinapril	drug	
SLC15A2	drug_target	
Amoxapine	drug	
GABRA1	drug_target	
Adalimumab	drug	
Ibuprofen	drug	
PLAT	drug_target	
THBD	drug_target	
ABCC1	drug_target	
SLC22A6	drug_target	
SLC22A8	drug_target	
ABCC4	drug_target	
SLC22A11	drug_target	
SLCO2B1	drug_target	
UGT1A3	drug_target	
FABP2	drug_target	
CFTR	drug_target	
BCL2	drug_target	
C3	intermediate	
CXCR6	intermediate	
CXCL8	intermediate	
CXCR4	intermediate	
CXCL10	intermediate	
CCL5	intermediate	
PPBP	intermediate	
NMUR1	intermediate	
TAS2R40	intermediate	
CCR6	intermediate	
CCR3	intermediate	
TAS2R20	intermediate	
BDKRB2	intermediate	
LPAR1	intermediate	
P2RY11	intermediate	
TRIP10	intermediate	
S1PR1	intermediate	
PTAFR	intermediate	
NPBWR1	intermediate	
GPR17	intermediate	
APP	intermediate	
NPY4R	intermediate	
complex:lAo9+jzjVOaRJSWZQvoh0G1mUDc	intermediate	
GABBR2	intermediate	
VIP	intermediate	
TAS2R16	intermediate	
TAS2R60	intermediate	
CCL21	intermediate	
FPR2	intermediate	
GNG2	intermediate	
NMU	intermediate	
FPR1	intermediate	
GPR55	intermediate	
GRM2	intermediate	
NPB	intermediate	
HEBP1	intermediate	
HP	intermediate	
PDYN	intermediate	
CCL16	intermediate	
CCL23	intermediate	
GRM8	intermediate	
TAS2R43	intermediate	
TAS2R7	intermediate	
TAS2R4	intermediate	
CCR1	intermediate	
SUCNR1	intermediate	
CYSLTR1	intermediate	
NMS	intermediate	
GCG	intermediate	
TAS2R8	intermediate	
PPY	intermediate	
S1PR2	intermediate	
CXCL5	intermediate	
RXFP4	intermediate	
S1PR5	intermediate	
TAS2R41	intermediate	
CXCR1	intermediate	
PF4	intermediate	
GPR18	intermediate	
IGF2R	intermediate	
CXCL3	intermediate	
TAS2R45	intermediate	
CASR	intermediate	
CXCR3	intermediate	
CXCL11	intermediate	
TAS2R46	intermediate	
CXCL6	intermediate	
SSTR4	intermediate	
TAS2R50	intermediate	
NPY2R	intermediate	
NLRC4	intermediate	
CNR2	intermediate	
CXCR2	intermediate	
CXCR5	intermediate	
P2RY13	intermediate	
CXCL13	intermediate	
KNG1	intermediate	
GRM6	intermediate	
CCL28	intermediate	
LPAR2	intermediate	
TAC1	intermediate	
CCR2	intermediate	
C5AR1	intermediate	
INSL5	intermediate	
ADORA3	intermediate	
GRM4	intermediate	
MT-RNR2	intermediate	
CXCL16	intermediate	
OPRL1	intermediate	
TAS2R9	intermediate	
APLNR	intermediate	
NPBWR2	intermediate	
POMC	intermediate	
P2RY4	intermediate	
PMCH	intermediate	
CCR7	intermediate	
MCHR1	intermediate	
HCAR2	intermediate	
GNAI1	intermediate	
HCAR3	intermediate	
GALR3	intermediate	
F2R	intermediate	
TAS2R31	intermediate	
TAS2R19	intermediate	
CXCL9	intermediate	
FPR3	intermediate	
GNAT3	intermediate	
NPY1R	intermediate	
LTB4R	intermediate	
GNB1	intermediate	
GNAI3	intermediate	
AGTR2	intermediate	
S1PR4	intermediate	
PNOC	intermediate	
TAS2R3	intermediate	
TAS2R1	intermediate	
TAS2R14	intermediate	
AGT	intermediate	
TAS2R10	intermediate	
MCHR2	intermediate	
NPY	intermediate	
NPS	intermediate	
PTGER3	intermediate	
CCR10	intermediate	
RLN3	intermediate	
OXER1	intermediate	
PENK	intermediate	
CXCL1	intermediate	
GALR2	intermediate	
LPAR5	intermediate	
CCR8	intermediate	
LPAR3	intermediate	
NPY5R	intermediate	
SAA1	intermediate	
GAL	intermediate	
C3AR1	intermediate	
S1PR3	intermediate	
TAS2R39	intermediate	
CORT	intermediate	
EGFR	intermediate	
SSTR3	intermediate	
ADORA2B	intermediate	
TAS2R38	intermediate	
CCL20	intermediate	
GALR1	intermediate	
CXCL2	intermediate	
PYY	intermediate	
MTNR1B	intermediate	
OXGR1	intermediate	
ACKR3	intermediate	
TAS2R5	intermediate	
HCAR1	intermediate	
TAS2R30	intermediate	
BDKRB1	intermediate	
GCGR	intermediate	
RXFP3	intermediate	
P2RY14	intermediate	
PTGDR2	intermediate	
MTNR1A	intermediate	
GPER1	intermediate	
APLN	intermediate	
NPSR1	intermediate	
F2RL1	intermediate	
GNAI2	intermediate	
NMUR2	intermediate	
GRM7	intermediate	
SST	intermediate	
TAS2R42	intermediate	
CCR4	intermediate	
CCL27	intermediate	
CCR9	intermediate	
CCL25	intermediate	
NPW	intermediate	
CCL19	intermediate	
CNR1	intermediate	
MYD88	intermediate	
SYK	intermediate	
IL5RA	intermediate	
CSF2	intermediate	
IL5	intermediate	
IL2	intermediate	
JAK3	intermediate	
GRB2	intermediate	
CAV1	intermediate	
MYLK	intermediate	
APOA1	intermediate	
FN1	intermediate	
CFB	intermediate	
ATM	intermediate	
rs1800629	intermediate	
STAT3	intermediate	
LTB	intermediate	
BIRC3	intermediate	
TNFRSF1A	intermediate	
rs3093726	intermediate	
TRAF3	intermediate	
LTBR	intermediate	
TRAF2	intermediate	
TP53	intermediate	
BIRC2	intermediate	
MAP3K14	intermediate	
RAMP3	intermediate	
IAPP	intermediate	
PTGDR	intermediate	
LHCGR	intermediate	
SCT	intermediate	
GPR32	intermediate	
GPR84	intermediate	
VIPR1	intermediate	
RXFP1	intermediate	
CALCB	intermediate	
GPR83	intermediate	
TAAR1	intermediate	
RLN2	intermediate	
PTH	intermediate	
TSHB	intermediate	
PTHLH	intermediate	
ADCYAP1R1	intermediate	
ADRB3	intermediate	
GPR45	intermediate	
PTH2R	intermediate	
CALCA	intermediate	
RAMP2	intermediate	
RXFP2	intermediate	
GHRHR	intermediate	
ADM	intermediate	
GPR20	intermediate	
GPBAR1	intermediate	
ADM2	intermediate	
LHB	intermediate	
PTGER4	intermediate	
GHRH	intermediate	
GIP	intermediate	
GPR150	intermediate	
MC1R	intermediate	
PTH2	intermediate	
VIPR2	intermediate	
CRHR1	intermediate	
GLP2R	intermediate	
CALCR	intermediate	
GPHA2	intermediate	
PTH1R	intermediate	
GPR176	intermediate	
MC3R	intermediate	
MC2R	intermediate	
CRH	intermediate	
CALCRL	intermediate	
CGA	intermediate	
GIPR	intermediate	
MC5R	intermediate	
ADCYAP1	intermediate	
INSL3	intermediate	
GNAS	intermediate	
RAMP1	intermediate	
SCTR	intermediate	
GPR27	intermediate	
GPR25	intermediate	
FSHR	intermediate	
FSHB	intermediate	
TSHR	intermediate	
GPR15	intermediate	
PTGER2	intermediate	
GPHB5	intermediate	
IL4	intermediate	
IL7	intermediate	
VIM	intermediate	
ACTN2	intermediate	
MED1	intermediate	
FABP5	intermediate	
F2	intermediate	
CARD11	intermediate	
NFKB1	intermediate	
NFKB2	intermediate	
NFKBIA	intermediate	
DERL1	intermediate	
PLG	intermediate	
