Insulin Detemir	drug	
CYP1A2	drug_target	
INSR	drug_target	
ALB	drug_target	
Proteinuria, low molecular weight, with hypercalciuria and nephrocalcinosis	phenotype	
Etodolac	drug	
PTGS2	drug_target	
PTGS1	drug_target	
CYP2C9	drug_target	
UGT1A9	drug_target	
SLC22A6	drug_target	
UGT1A3	drug_target	
UGT1A10	drug_target	
UGT2B7	drug_target	
RXRA	drug_target	
Sulindac	drug	
AKR1B1	drug_target	
PPARD	drug_target	
CYP1A1	drug_target	
PTGDR2	drug_target	
MAPK3	drug_target	
Flurbiprofen	drug	
ABCC4	drug_target	
UGT1A1	drug_target	
UGT2B4	drug_target	
Dasatinib	drug	
ABCB1	drug_target	
CYP3A4	drug_target	
CYP3A5	drug_target	
ABCG2	drug_target	
PDGFRB	drug_target	
CYP1B1	drug_target	
ABL2	drug_target	
ABL1	drug_target	
FMO3	drug_target	
KIT	drug_target	
SRC	drug_target	
EPHA2	drug_target	
LCK	drug_target	
YES1	drug_target	
STAT5B	drug_target	
FYN	drug_target	
Diflunisal	drug	
UGT1A8	drug_target	
TTR	drug_target	
Captopril	drug	
CYP2D6	drug_target	
ACE	drug_target	
MMP2	drug_target	
MMP9	drug_target	
LTA4H	drug_target	
Proteinuria Adverse Event	phenotype	
Perindopril	drug	
BCHE	drug_target	
SLC15A2	drug_target	
Valsartan	drug	
SLCO1B1	drug_target	
SLCO1B3	drug_target	
AGTR1	drug_target	
Celecoxib	drug	
CYP2C8	drug_target	
ORM1	drug_target	
PDPK1	drug_target	
Piroxicam	drug	
SLC22A8	drug_target	
SLC22A11	drug_target	
Benazepril	drug	
MTHFR	drug_target	
Ramipril	drug	
Trandolapril	drug	
CES1	drug_target	
Ibuprofen	drug	
PLAT	drug_target	
THBD	drug_target	
CYP2C19	drug_target	
ABCC1	drug_target	
SLCO1A2	drug_target	
PPARG	drug_target	
SLCO2B1	drug_target	
FABP2	drug_target	
CFTR	drug_target	
BCL2	drug_target	
Indomethacin	drug	
ABCC2	drug_target	
ABCC3	drug_target	
SLC10A1	drug_target	
GLO1	drug_target	
ABCC11	drug_target	
PLA2G2A	drug_target	
PTGR2	drug_target	
PPARA	drug_target	
ABCC6	drug_target	
Vandetanib	drug	
EGFR	drug_target	
VEGFA	drug_target	
FMO1	drug_target	
TEK	drug_target	
PTK6	drug_target	
Naproxen	drug	
Oxcarbazepine	drug	
SCN5A	drug_target	
Auranofin	drug	
IKBKB	drug_target	
PRDX5	drug_target	
Ramucirumab	drug	
KDR	drug_target	
Acitretin	drug	
RBP1	drug_target	
CYP26A1	drug_target	
RARG	drug_target	
RARB	drug_target	
RXRG	drug_target	
RXRB	drug_target	
RARA	drug_target	
complex:lAo9+jzjVOaRJSWZQvoh0G1mUDc	intermediate	
CFH	intermediate	
CTSL	intermediate	
APOA1	intermediate	
APOE	intermediate	
INS	intermediate	
NPHS1	intermediate	
FN1	intermediate	
HP	intermediate	
NCOA3	intermediate	
PPBP	intermediate	
SAA1	intermediate	
POMC	intermediate	
FGF16	intermediate	
HRAS	intermediate	
FGA	intermediate	
HLA-DRB1	intermediate	
NCK1	intermediate	
FGF8	intermediate	
PAK2	intermediate	
NRG1	intermediate	
RHOA	intermediate	
HBEGF	intermediate	
HLA-DQA1	intermediate	
PTPN22	intermediate	
ERBB2	intermediate	
ERBB4	intermediate	
FGF23	intermediate	
PIK3CA	intermediate	
SHC1	intermediate	
KLB	intermediate	
FGF18	intermediate	
NRG4	intermediate	
FGF4	intermediate	
FGFR4	intermediate	
CD80	intermediate	
FGFR3	intermediate	
CD2AP	intermediate	
FGFR2	intermediate	
LYN	intermediate	
FGF7	intermediate	
FGF17	intermediate	
SOS1	intermediate	
KITLG	intermediate	
HLA-DPB1	intermediate	
FGF22	intermediate	
FGFR1	intermediate	
FGF2	intermediate	
FGF5	intermediate	
PTPN11	intermediate	
FRS2	intermediate	
JAK2	intermediate	
PAK1	intermediate	
EREG	intermediate	
B2M	intermediate	
NCK2	intermediate	
PIK3R2	intermediate	
CDC42	intermediate	
FGF3	intermediate	
FGF1	intermediate	
FGF19	intermediate	
PIK3CB	intermediate	
PIK3R1	intermediate	
FGF20	intermediate	
GRB2	intermediate	
FGF10	intermediate	
KL	intermediate	
FGF9	intermediate	
BTC	intermediate	
FGF6	intermediate	
AGT	intermediate	
REN	intermediate	
ADRA1B	intermediate	
SCARB2	intermediate	
DERL1	intermediate	
OCRL	intermediate	
LRP2	intermediate	
HDAC3	intermediate	
MED1	intermediate	
NCOR2	intermediate	
NCOR1	intermediate	
PTK2	intermediate	
RET	intermediate	
LAT	intermediate	
HSP90AA1	intermediate	
CRABP2	intermediate	
