Lisinopril	drug	
ABCB1	drug_target	
ACE	drug_target	
ACE2	drug_target	
High altitude pulmonary edema	phenotype	
Candesartan	drug	
PTGS1	drug_target	
CYP2C9	drug_target	
CYP2C8	drug_target	
AGTR1	drug_target	
UGT1A3	drug_target	
Ropinirole	drug	
CYP1A2	drug_target	
CYP2D6	drug_target	
CYP3A4	drug_target	
DRD2	drug_target	
HTR2C	drug_target	
HTR1D	drug_target	
HTR1B	drug_target	
HTR1A	drug_target	
HTR2B	drug_target	
HTR2A	drug_target	
DRD1	drug_target	
DRD5	drug_target	
DRD3	drug_target	
DRD4	drug_target	
ADRA2A	drug_target	
ADRA2B	drug_target	
ADRA2C	drug_target	
Pulmonary edema	phenotype	
Eprosartan	drug	
ABCC2	drug_target	
Carvedilol	drug	
XDH	drug_target	
CYP2E1	drug_target	
VEGFA	drug_target	
NDUFC2	drug_target	
CYP1A1	drug_target	
ADRB1	drug_target	
ADRB2	drug_target	
KCNH2	drug_target	
ADRA1A	drug_target	
ADRA1B	drug_target	
ADRA1D	drug_target	
VCAM1	drug_target	
NPPB	drug_target	
GJA1	drug_target	
SELE	drug_target	
HIF1A	drug_target	
L-Tyrosine	drug	
TAT	drug_target	
SLC16A10	drug_target	
SLC16A2	drug_target	
TH	drug_target	
YARS2	drug_target	
YARS	drug_target	
Trandolapril	drug	
SLC15A2	drug_target	
CES1	drug_target	
Olmesartan	drug	
SLCO1B1	drug_target	
SLCO1B3	drug_target	
Pramipexole	drug	
SLC22A2	drug_target	
SLC22A1	drug_target	
Telmisartan	drug	
CYP2C19	drug_target	
ABCG2	drug_target	
PPARG	drug_target	
Epoprostenol	drug	
P2RY12	drug_target	
PTGIR	drug_target	
PTGIS	drug_target	
Pergolide	drug	
Enalapril	drug	
SLCO1A2	drug_target	
SLC22A6	drug_target	
SLC22A8	drug_target	
Enalaprilat	drug	
Quinapril	drug	
Irbesartan	drug	
JUN	drug_target	
Fosinopril	drug	
AGT	intermediate	
REN	intermediate	
EDNRA	intermediate	
EDN1	intermediate	
NMUR1	intermediate	
PMCH	intermediate	
GHRH	intermediate	
CCR5	intermediate	
CXCL2	intermediate	
BDKRB2	intermediate	
LPAR1	intermediate	
P2RY11	intermediate	
CASR	intermediate	
GPR17	intermediate	
APP	intermediate	
F2R	intermediate	
GNG2	intermediate	
NMU	intermediate	
FPR1	intermediate	
GNB1	intermediate	
BDKRB1	intermediate	
CXCL8	intermediate	
GCGR	intermediate	
KNG1	intermediate	
NPSR1	intermediate	
NMUR2	intermediate	
LPAR2	intermediate	
CCL23	intermediate	
NPS	intermediate	
RLN3	intermediate	
GCG	intermediate	
NMS	intermediate	
FSHR	intermediate	
LPAR5	intermediate	
LPAR3	intermediate	
SAA1	intermediate	
POMC	intermediate	
ALB	intermediate	
ROCK1	intermediate	
complex:lAo9+jzjVOaRJSWZQvoh0G1mUDc	intermediate	
EGLN1	intermediate	
UBC	intermediate	
