Pramipexole	drug	
SLC22A2	drug_target	
SLC22A1	drug_target	
DRD2	drug_target	
HTR2C	drug_target	
HTR1D	drug_target	
HTR1B	drug_target	
HTR1A	drug_target	
HTR2B	drug_target	
HTR2A	drug_target	
DRD1	drug_target	
DRD5	drug_target	
DRD3	drug_target	
DRD4	drug_target	
ADRA2A	drug_target	
ADRA2B	drug_target	
ADRA2C	drug_target	
Sepsis	phenotype	
Golimumab	drug	
TNF	drug_target	
Severe Sepsis	phenotype	
Gabapentin	drug	
BCAT1	drug_target	
ADORA1	drug_target	
CACNA2D1	drug_target	
CACNA2D2	drug_target	
CACNA1B	drug_target	
Canakinumab	drug	
IL1B	drug_target	
Ticlopidine	drug	
MPO	drug_target	
CYP1A2	drug_target	
CYP2D6	drug_target	
CYP3A4	drug_target	
CYP2E1	drug_target	
CYP2C9	drug_target	
CYP2C19	drug_target	
CYP2C8	drug_target	
CYP1A1	drug_target	
CYP2B6	drug_target	
P2RY12	drug_target	
Tofacitinib	drug	
ALB	drug_target	
JAK2	drug_target	
JAK1	drug_target	
JAK3	drug_target	
Memantine	drug	
GRIN1	drug_target	
GRIN2A	drug_target	
GRIN2B	drug_target	
GRIN3A	drug_target	
CYP2A6	drug_target	
HTR3A	drug_target	
Fentanyl	drug	
ABCB1	drug_target	
CYP3A5	drug_target	
OPRM1	drug_target	
OPRK1	drug_target	
OPRD1	drug_target	
Aminophylline	drug	
HDAC2	drug_target	
PDE3A	drug_target	
Ibrutinib	drug	
BTK	drug_target	
Goserelin	drug	
GNRHR	drug_target	
LHCGR	drug_target	
Sulfasalazine	drug	
PTGS2	drug_target	
PTGS1	drug_target	
ABCC2	drug_target	
ABCG2	drug_target	
SLC7A11	drug_target	
SLC46A1	drug_target	
PPARG	drug_target	
ALOX5	drug_target	
CHUK	drug_target	
IKBKB	drug_target	
ACAT1	drug_target	
TBXAS1	drug_target	
PLA2G1B	drug_target	
Diphenoxylate	drug	
Niacin	drug	
SLC16A3	drug_target	
SLC16A1	drug_target	
SLC22A5	drug_target	
SLCO2B1	drug_target	
HCAR3	drug_target	
HCAR2	drug_target	
QPRT	drug_target	
NNMT	drug_target	
SLC5A8	drug_target	
Cocaine	drug	
SLC6A4	drug_target	
SLC6A3	drug_target	
SLC6A2	drug_target	
CHRM1	drug_target	
SCN5A	drug_target	
CHRM2	drug_target	
SCN10A	drug_target	
Ketoprofen	drug	
SLCO1A2	drug_target	
SLC22A6	drug_target	
SLC22A8	drug_target	
ABCC4	drug_target	
SLC22A11	drug_target	
CXCR1	drug_target	
Ropinirole	drug	
Abatacept	drug	
CD86	drug_target	
CD80	drug_target	
Menthol	drug	
TRPM8	drug_target	
Aldesleukin	drug	
IL2RA	drug_target	
IL2RB	drug_target	
IL2RG	drug_target	
PLA2G4A	drug_target	
XDH	drug_target	
Etanercept	drug	
FCGR3B	drug_target	
C1R	drug_target	
C1QA	drug_target	
C1QB	drug_target	
C1QC	drug_target	
FCGR3A	drug_target	
C1S	drug_target	
FCGR1A	drug_target	
FCGR2A	drug_target	
FCGR2B	drug_target	
FCGR2C	drug_target	
TNFRSF1B	drug_target	
LTA	drug_target	
Sumatriptan	drug	
SLCO1B1	drug_target	
MAOA	drug_target	
HTR1F	drug_target	
Atropine	drug	
CHRM3	drug_target	
CHRM4	drug_target	
CHRM5	drug_target	
Infliximab	drug	
Paroxetine	drug	
Cevimeline	drug	
FMO1	drug_target	
Glycine	drug	
AGXT2	drug_target	
SHMT1	drug_target	
GCAT	drug_target	
GLDC	drug_target	
ALAS1	drug_target	
AGXT	drug_target	
SHMT2	drug_target	
ALAS2	drug_target	
SLC16A10	drug_target	
GNMT	drug_target	
GATM	drug_target	
GRIN3B	drug_target	
GRIN2C	drug_target	
GSS	drug_target	
GCSH	drug_target	
GARS	drug_target	
BAAT	drug_target	
GPR18	drug_target	
GLYAT	drug_target	
SLC32A1	drug_target	
PIPOX	drug_target	
SLC6A5	drug_target	
SLC6A9	drug_target	
GLRA1	drug_target	
GLRB	drug_target	
GLRA3	drug_target	
GLRA2	drug_target	
Eculizumab	drug	
C5	drug_target	
Certolizumab pegol	drug	
NMUR1	intermediate	
PMCH	intermediate	
P2RY1	intermediate	
GRP	intermediate	
BDKRB2	intermediate	
LPAR1	intermediate	
CXCL2	intermediate	
EDN1	intermediate	
P2RY11	intermediate	
CASR	intermediate	
GPR17	intermediate	
APP	intermediate	
EDN3	intermediate	
F2R	intermediate	
FPR2	intermediate	
NTS	intermediate	
GNG2	intermediate	
CXCL12	intermediate	
NMU	intermediate	
EDNRB	intermediate	
CXCR2	intermediate	
LTB4R	intermediate	
GNB1	intermediate	
BDKRB1	intermediate	
CXCL8	intermediate	
AGTR2	intermediate	
GCGR	intermediate	
PNOC	intermediate	
CXCR4	intermediate	
KNG1	intermediate	
CCL5	intermediate	
NPSR1	intermediate	
C3	intermediate	
CALCA	intermediate	
GRPR	intermediate	
NMUR2	intermediate	
AGT	intermediate	
LPAR2	intermediate	
CCR2	intermediate	
C5AR1	intermediate	
CCL23	intermediate	
ADRA1D	intermediate	
NPS	intermediate	
SST	intermediate	
RLN3	intermediate	
F2	intermediate	
GCG	intermediate	
NMS	intermediate	
ADM	intermediate	
LPAR5	intermediate	
GAST	intermediate	
CRH	intermediate	
LPAR3	intermediate	
GAL	intermediate	
SAA1	intermediate	
S1PR3	intermediate	
POMC	intermediate	
C3AR1	intermediate	
P2RY2	intermediate	
TNFRSF1A	intermediate	
rs1800629	intermediate	
IRAK1	intermediate	
MYD88	intermediate	
IL1R1	intermediate	
IRAK4	intermediate	
MGST1	intermediate	
MGST3	intermediate	
MGST2	intermediate	
APOE	intermediate	
CFB	intermediate	
PIK3CD	intermediate	
complex:lAo9+jzjVOaRJSWZQvoh0G1mUDc	intermediate	
IFNG	intermediate	
FYN	intermediate	
F7	intermediate	
SOCS3	intermediate	
GSN	intermediate	
FN1	intermediate	
IL7R	intermediate	
STAT3	intermediate	
CFH	intermediate	
STAT1	intermediate	
GHR	intermediate	
APOA1	intermediate	
IL10RA	intermediate	
CSF2	intermediate	
IFNA2	intermediate	
IL2	intermediate	
IRS1	intermediate	
SERPING1	intermediate	
IL7	intermediate	
TTN	intermediate	
APOC1	intermediate	
SOCS1	intermediate	
BBC3	intermediate	
IL4	intermediate	
GRAP2	intermediate	
PIK3CB	intermediate	
PIK3R1	intermediate	
TIRAP	intermediate	
TRAF6	intermediate	
LY96	intermediate	
TLR6	intermediate	
CD14	intermediate	
TLR4	intermediate	
TLR1	intermediate	
CARD11	intermediate	
NFKB1	intermediate	
NFKB2	intermediate	
NOD1	intermediate	
RELA	intermediate	
NOD2	intermediate	
TAB3	intermediate	
NFKBIA	intermediate	
SYT1	intermediate	
TFRC	intermediate	
ADRB2	intermediate	
WNT5A	intermediate	
AAK1	intermediate	
GABBR1	intermediate	
PPBP	intermediate	
PIK3CA	intermediate	
TRAF3	intermediate	
TRAF2	intermediate	
MAP3K14	intermediate	
BIRC3	intermediate	
BIRC2	intermediate	
TAS2R40	intermediate	
CCR6	intermediate	
CCR3	intermediate	
CCR5	intermediate	
TAS2R20	intermediate	
S1PR1	intermediate	
NPBWR1	intermediate	
NPY4R	intermediate	
GABBR2	intermediate	
TAS2R16	intermediate	
TAS2R60	intermediate	
CCL21	intermediate	
GPR55	intermediate	
FPR1	intermediate	
GRM2	intermediate	
NPB	intermediate	
HEBP1	intermediate	
PDYN	intermediate	
CCL16	intermediate	
HTR5A	intermediate	
TAS2R4	intermediate	
TAS2R7	intermediate	
GRM8	intermediate	
TAS2R43	intermediate	
CCR1	intermediate	
SUCNR1	intermediate	
TAS2R8	intermediate	
S1PR2	intermediate	
PPY	intermediate	
SSTR5	intermediate	
CXCL5	intermediate	
RXFP4	intermediate	
S1PR5	intermediate	
TAS2R41	intermediate	
PF4	intermediate	
CXCL3	intermediate	
TAS2R45	intermediate	
CXCL11	intermediate	
TAS2R46	intermediate	
CXCR3	intermediate	
CXCL6	intermediate	
SSTR4	intermediate	
TAS2R50	intermediate	
NPY2R	intermediate	
CNR2	intermediate	
P2RY13	intermediate	
CXCR5	intermediate	
CXCL13	intermediate	
GRM6	intermediate	
CCL28	intermediate	
INSL5	intermediate	
ADORA3	intermediate	
HRH3	intermediate	
GRM4	intermediate	
MT-RNR2	intermediate	
CXCL16	intermediate	
OPRL1	intermediate	
TAS2R9	intermediate	
APLNR	intermediate	
NPBWR2	intermediate	
P2RY4	intermediate	
CCR7	intermediate	
MCHR1	intermediate	
GNAI1	intermediate	
GALR3	intermediate	
TAS2R31	intermediate	
TAS2R19	intermediate	
HTR1E	intermediate	
CXCL9	intermediate	
FPR3	intermediate	
GNAT3	intermediate	
NPY1R	intermediate	
ANXA1	intermediate	
GNAI3	intermediate	
S1PR4	intermediate	
TAS2R3	intermediate	
CXCL10	intermediate	
TAS2R1	intermediate	
TAS2R14	intermediate	
TAS2R10	intermediate	
MCHR2	intermediate	
NPY	intermediate	
PTGER3	intermediate	
CCR10	intermediate	
OXER1	intermediate	
PENK	intermediate	
CXCL1	intermediate	
GALR2	intermediate	
CXCR6	intermediate	
CCR8	intermediate	
NPY5R	intermediate	
TAS2R39	intermediate	
SSTR1	intermediate	
CORT	intermediate	
SSTR3	intermediate	
TAS2R38	intermediate	
CCL20	intermediate	
SSTR2	intermediate	
GALR1	intermediate	
PYY	intermediate	
MTNR1B	intermediate	
OXGR1	intermediate	
ACKR3	intermediate	
TAS2R5	intermediate	
HCAR1	intermediate	
TAS2R30	intermediate	
P2RY14	intermediate	
PTGDR2	intermediate	
RXFP3	intermediate	
MTNR1A	intermediate	
GPER1	intermediate	
APLN	intermediate	
GNAI2	intermediate	
GRM7	intermediate	
HRH4	intermediate	
TAS2R42	intermediate	
CCR4	intermediate	
CCL27	intermediate	
CCL25	intermediate	
CCR9	intermediate	
NPW	intermediate	
CCL19	intermediate	
CNR1	intermediate	
DLD	intermediate	
C6	intermediate	
