Perphenazine	drug	
CYP1A2	drug_target	
CYP2D6	drug_target	
CYP3A4	drug_target	
CYP2C9	drug_target	
CYP2C18	drug_target	
CYP2C19	drug_target	
CYP2C8	drug_target	
CYP2B6	drug_target	
DRD2	drug_target	
DRD1	drug_target	
CALM3	drug_target	
Tardive Dyskinesia	phenotype	
Asenapine	drug	
ADRB1	drug_target	
HTR2C	drug_target	
ADRB2	drug_target	
UGT1A4	drug_target	
ADRA1A	drug_target	
HRH1	drug_target	
HTR1B	drug_target	
HTR1A	drug_target	
HTR2B	drug_target	
HTR7	drug_target	
HTR2A	drug_target	
DRD3	drug_target	
DRD4	drug_target	
HTR6	drug_target	
ADRA2A	drug_target	
ADRA2B	drug_target	
ADRA2C	drug_target	
HRH2	drug_target	
HTR5A	drug_target	
Loxapine	drug	
SLC6A4	drug_target	
SLC6A3	drug_target	
SLC6A2	drug_target	
CHRM3	drug_target	
CHRM1	drug_target	
CHRM2	drug_target	
ADRA1B	drug_target	
HTR1D	drug_target	
HTR1E	drug_target	
DRD5	drug_target	
HTR3A	drug_target	
CHRM4	drug_target	
CHRM5	drug_target	
HRH4	drug_target	
Tetrabenazine	drug	
SLC18A2	drug_target	
CBR1	drug_target	
Lurasidone	drug	
Thiothixene	drug	
ALB	drug_target	
SLC22A1	drug_target	
Chlorpromazine	drug	
ABCB1	drug_target	
CYP2E1	drug_target	
BCHE	drug_target	
ABCB11	drug_target	
KCNH2	drug_target	
SMPD1	drug_target	
Fluvoxamine	drug	
CYP3A5	drug_target	
CYP1A1	drug_target	
Venlafaxine	drug	
ABCG2	drug_target	
Ziprasidone	drug	
Risperidone	drug	
Olanzapine	drug	
FMO3	drug_target	
ORM1	drug_target	
Paliperidone	drug	
Zolmitriptan	drug	
MAOA	drug_target	
HTR1F	drug_target	
Prochlorperazine	drug	
Iloperidone	drug	
Escitalopram	drug	
Bupropion	drug	
CYP2A6	drug_target	
CHRNA3	drug_target	
Pimozide	drug	
Fluoxetine	drug	
Clozapine	drug	
CYP1B1	drug_target	
CALY	drug_target	
Buspirone	drug	
Amoxapine	drug	
GABRA1	drug_target	
Molindone	drug	
Aripiprazole	drug	
Thioridazine	drug	
Memantine	drug	
SLC22A2	drug_target	
GRIN1	drug_target	
GRIN2A	drug_target	
GRIN2B	drug_target	
GRIN3A	drug_target	
Quetiapine	drug	
ADRA1D	drug_target	
Haloperidol	drug	
UGT1A9	drug_target	
Trihexyphenidyl	drug	
Fluphenazine	drug	
Doxepin	drug	
Amitriptyline	drug	
OPRM1	drug_target	
OPRK1	drug_target	
OPRD1	drug_target	
KCNA1	drug_target	
KCND2	drug_target	
KCND3	drug_target	
NTRK1	drug_target	
NTRK2	drug_target	
KCNQ2	drug_target	
SIGMAR1	drug_target	
KCNQ3	drug_target	
Trazodone	drug	
Selegiline	drug	
MAOB	drug_target	
MGST3	intermediate	
MTNR1A	intermediate	
AKT1	intermediate	
MGST1	intermediate	
GNG2	intermediate	
GNB1	intermediate	
MTNR1B	intermediate	
MGST2	intermediate	
POMC	intermediate	
RLN3	intermediate	
CNR1	intermediate	
CCR5	intermediate	
PTGDR	intermediate	
NPBWR1	intermediate	
PTGER1	intermediate	
GPR17	intermediate	
NPY4R	intermediate	
VIP	intermediate	
GPR65	intermediate	
TAS2R16	intermediate	
FPR2	intermediate	
NPB	intermediate	
RXFP1	intermediate	
HEBP1	intermediate	
CCL5	intermediate	
CCL16	intermediate	
CALCB	intermediate	
TAS2R4	intermediate	
AVPR1A	intermediate	
SUCNR1	intermediate	
GCG	intermediate	
PPY	intermediate	
PROK1	intermediate	
SSTR5	intermediate	
GRM1	intermediate	
FFAR3	intermediate	
CXCR3	intermediate	
SSTR4	intermediate	
GNA15	intermediate	
CXCR2	intermediate	
ADRB3	intermediate	
CXCL13	intermediate	
F2RL3	intermediate	
CALCA	intermediate	
RXFP2	intermediate	
INSL5	intermediate	
CXCL16	intermediate	
TACR3	intermediate	
TAS2R9	intermediate	
APLNR	intermediate	
NPBWR2	intermediate	
P2RY1	intermediate	
KISS1	intermediate	
MC1R	intermediate	
P2RY10	intermediate	
TAS2R19	intermediate	
XCR1	intermediate	
LTB4R	intermediate	
GNAT3	intermediate	
KISS1R	intermediate	
GNAI3	intermediate	
S1PR4	intermediate	
GLP2R	intermediate	
NTSR2	intermediate	
PTGER3	intermediate	
CCR10	intermediate	
HCRTR2	intermediate	
EDNRA	intermediate	
MC2R	intermediate	
LPAR5	intermediate	
CRH	intermediate	
CALCRL	intermediate	
TAS2R38	intermediate	
GALR1	intermediate	
CCK	intermediate	
GNRH2	intermediate	
TAS2R30	intermediate	
GCGR	intermediate	
P2RY14	intermediate	
APLN	intermediate	
QRFPR	intermediate	
MLN	intermediate	
GRPR	intermediate	
CCKAR	intermediate	
TSHR	intermediate	
NMUR1	intermediate	
CCR6	intermediate	
RAMP3	intermediate	
CCR3	intermediate	
LPAR1	intermediate	
S1PR1	intermediate	
GPR32	intermediate	
FFAR2	intermediate	
NTS	intermediate	
GPR55	intermediate	
FPR1	intermediate	
CXCR4	intermediate	
C3	intermediate	
HCRT	intermediate	
GPR83	intermediate	
PROKR1	intermediate	
TAS2R43	intermediate	
TAS2R7	intermediate	
S1PR2	intermediate	
CXCL5	intermediate	
CXCR1	intermediate	
TAS2R41	intermediate	
NMB	intermediate	
PF4	intermediate	
CXCL3	intermediate	
PTH	intermediate	
CXCL11	intermediate	
TSHB	intermediate	
NPY2R	intermediate	
EDNRB	intermediate	
GPR45	intermediate	
P2RY6	intermediate	
CCL28	intermediate	
RAMP2	intermediate	
GHRHR	intermediate	
C5AR1	intermediate	
HRH3	intermediate	
GPR68	intermediate	
TRH	intermediate	
GHRH	intermediate	
TAS2R31	intermediate	
FPR3	intermediate	
ANXA1	intermediate	
AGTR2	intermediate	
PROKR2	intermediate	
PNOC	intermediate	
TAS2R14	intermediate	
CALCR	intermediate	
GPHA2	intermediate	
PTH1R	intermediate	
NPY	intermediate	
OXER1	intermediate	
PENK	intermediate	
GALR2	intermediate	
S1PR3	intermediate	
TAS2R39	intermediate	
LTB4R2	intermediate	
CORT	intermediate	
SSTR3	intermediate	
ADORA2B	intermediate	
CGA	intermediate	
GIPR	intermediate	
MC5R	intermediate	
ADCYAP1	intermediate	
OXGR1	intermediate	
TAS2R5	intermediate	
GNA11	intermediate	
CXCL12	intermediate	
GNRH1	intermediate	
RAMP1	intermediate	
F2RL1	intermediate	
GNAI2	intermediate	
NMUR2	intermediate	
GRM7	intermediate	
LPAR4	intermediate	
FSHR	intermediate	
FSHB	intermediate	
CCL25	intermediate	
NPW	intermediate	
TAC3	intermediate	
IAPP	intermediate	
TAS2R20	intermediate	
BDKRB2	intermediate	
P2RY11	intermediate	
EDN1	intermediate	
GPR84	intermediate	
CCL21	intermediate	
NMU	intermediate	
GRM2	intermediate	
PDYN	intermediate	
PROK2	intermediate	
OXTR	intermediate	
CCL23	intermediate	
CCR1	intermediate	
TAS2R8	intermediate	
PPBP	intermediate	
S1PR5	intermediate	
TACR1	intermediate	
CASR	intermediate	
RLN2	intermediate	
EDN3	intermediate	
TAS2R50	intermediate	
GPR4	intermediate	
CNR2	intermediate	
UTS2R	intermediate	
PTH2R	intermediate	
GRM6	intermediate	
TAS2R13	intermediate	
LPAR2	intermediate	
GRM4	intermediate	
ADM	intermediate	
GPBAR1	intermediate	
P2RY4	intermediate	
CCR7	intermediate	
MCHR1	intermediate	
PTGFR	intermediate	
AVPR1B	intermediate	
HCAR2	intermediate	
MLNR	intermediate	
GIP	intermediate	
GPR150	intermediate	
NPY1R	intermediate	
UTS2	intermediate	
NTSR1	intermediate	
CXCL10	intermediate	
TAS2R1	intermediate	
ADORA1	intermediate	
MCHR2	intermediate	
TAS2R10	intermediate	
NPS	intermediate	
F2	intermediate	
PTGIR	intermediate	
MC3R	intermediate	
P2RY12	intermediate	
XCL1	intermediate	
CXCR6	intermediate	
LPAR3	intermediate	
SSTR1	intermediate	
OPN4	intermediate	
SSTR2	intermediate	
HTR4	intermediate	
ARRB2	intermediate	
EDN2	intermediate	
UTS2B	intermediate	
INSL3	intermediate	
GNAS	intermediate	
BDKRB1	intermediate	
RXFP3	intermediate	
GNA14	intermediate	
GPER1	intermediate	
NPSR1	intermediate	
GABBR1	intermediate	
GPR27	intermediate	
CCKBR	intermediate	
GPR25	intermediate	
TAS2R42	intermediate	
P2RY2	intermediate	
GNAQ	intermediate	
CCL19	intermediate	
TAS2R40	intermediate	
FFAR1	intermediate	
PTAFR	intermediate	
SCT	intermediate	
LHCGR	intermediate	
APP	intermediate	
GABBR2	intermediate	
TAS2R60	intermediate	
VIPR1	intermediate	
NPFFR2	intermediate	
GHRL	intermediate	
QRFP	intermediate	
GRM8	intermediate	
CYSLTR1	intermediate	
NMS	intermediate	
NPFFR1	intermediate	
TRHR	intermediate	
GAST	intermediate	
RXFP4	intermediate	
TAAR1	intermediate	
C5	intermediate	
GPR18	intermediate	
TAS2R45	intermediate	
XCL2	intermediate	
TAS2R46	intermediate	
CXCL6	intermediate	
PTHLH	intermediate	
ADCYAP1R1	intermediate	
CXCR5	intermediate	
P2RY13	intermediate	
GHSR	intermediate	
KNG1	intermediate	
GPRC6A	intermediate	
LPAR6	intermediate	
OXT	intermediate	
TAC1	intermediate	
CCR2	intermediate	
GNRHR2	intermediate	
ADORA3	intermediate	
MT-RNR2	intermediate	
GPR20	intermediate	
OPRL1	intermediate	
ADM2	intermediate	
LHB	intermediate	
PTGER4	intermediate	
PMCH	intermediate	
GNAI1	intermediate	
HCAR3	intermediate	
GALR3	intermediate	
F2R	intermediate	
PTH2	intermediate	
CXCL9	intermediate	
VIPR2	intermediate	
GRM5	intermediate	
CXCL8	intermediate	
CRHR1	intermediate	
TAS2R3	intermediate	
GNRHR	intermediate	
AGT	intermediate	
GPR176	intermediate	
TACR2	intermediate	
CXCL1	intermediate	
CCR8	intermediate	
NPY5R	intermediate	
GAL	intermediate	
SAA1	intermediate	
C3AR1	intermediate	
NMBR	intermediate	
CCL20	intermediate	
CXCL2	intermediate	
GRP	intermediate	
PYY	intermediate	
ACKR3	intermediate	
HCAR1	intermediate	
PTGDR2	intermediate	
CYSLTR2	intermediate	
SCTR	intermediate	
HCRTR1	intermediate	
SST	intermediate	
GPR132	intermediate	
NPFF	intermediate	
GPR15	intermediate	
CCR4	intermediate	
CCL27	intermediate	
CCR9	intermediate	
PTGER2	intermediate	
GPHB5	intermediate	
F2RL2	intermediate	
complex:lAo9+jzjVOaRJSWZQvoh0G1mUDc	intermediate	
APOE	intermediate	
rs1800544	intermediate	
PDE4B	intermediate	
