Tirofiban	drug	
ITGB3	drug_target	
ITGA2B	drug_target	
Thrombocytopenia, platelet dysfunction, hemolysis, and imbalanced globin synthesis	phenotype	
Abciximab	drug	
FCGR3B	drug_target	
C1R	drug_target	
C1QA	drug_target	
C1QB	drug_target	
C1QC	drug_target	
FCGR3A	drug_target	
C1S	drug_target	
FCGR1A	drug_target	
FCGR2A	drug_target	
FCGR2B	drug_target	
FCGR2C	drug_target	
VTN	drug_target	
Interferon beta-1a	drug	
IFNAR2	drug_target	
IFNAR1	drug_target	
Didanosine	drug	
SLC22A6	drug_target	
SLC29A1	drug_target	
PNP	drug_target	
SLC29A2	drug_target	
Autoimmune thrombocytopenia	phenotype	
Interferon gamma-1b	drug	
CYP1A2	drug_target	
IFNGR1	drug_target	
IFNGR2	drug_target	
Bosutinib	drug	
ABCB1	drug_target	
CYP3A4	drug_target	
ABL1	drug_target	
SRC	drug_target	
HCK	drug_target	
CDK2	drug_target	
MAP2K1	drug_target	
LYN	drug_target	
BCR	drug_target	
MAP2K2	drug_target	
MAP3K2	drug_target	
CAMK2G	drug_target	
Auranofin	drug	
ALB	drug_target	
IKBKB	drug_target	
PRDX5	drug_target	
Pentosan Polysulfate	drug	
FGF2	drug_target	
FGF1	drug_target	
FGF4	drug_target	
Nintedanib	drug	
FGFR2	drug_target	
FGFR1	drug_target	
FGFR3	drug_target	
FLT4	drug_target	
KDR	drug_target	
FLT3	drug_target	
FLT1	drug_target	
LCK	drug_target	
Ruxolitinib	drug	
JAK2	drug_target	
JAK1	drug_target	
Olsalazine	drug	
TPMT	drug_target	
IFNG	drug_target	
Sunitinib	drug	
ABCC2	drug_target	
CYP3A5	drug_target	
ABCG2	drug_target	
PDGFRB	drug_target	
PDGFRA	drug_target	
ABCC4	drug_target	
KIT	drug_target	
CSF1R	drug_target	
Interferon alfacon-1	drug	
Pazopanib	drug	
CYP2D6	drug_target	
CYP2C8	drug_target	
SLCO1B1	drug_target	
UGT1A1	drug_target	
ITK	drug_target	
SH2B3	drug_target	
Peginterferon alfa-2a	drug	
Trastuzumab	drug	
EGFR	drug_target	
ERBB2	drug_target	
CYP19A1	drug_target	
Ofatumumab	drug	
MS4A1	drug_target	
Ponatinib	drug	
FGFR4	drug_target	
ABCB11	drug_target	
RET	drug_target	
TEK	drug_target	
Imatinib	drug	
PTGS1	drug_target	
CYP2C9	drug_target	
CYP2C19	drug_target	
SLC22A2	drug_target	
SLC22A1	drug_target	
ORM1	drug_target	
NTRK1	drug_target	
DDR1	drug_target	
ABCA3	drug_target	
Dasatinib	drug	
CYP1B1	drug_target	
CYP1A1	drug_target	
ABL2	drug_target	
FMO3	drug_target	
EPHA2	drug_target	
YES1	drug_target	
STAT5B	drug_target	
FYN	drug_target	
Blinatumomab	drug	
CD3D	drug_target	
CD19	drug_target	
Vandetanib	drug	
ABCC1	drug_target	
VEGFA	drug_target	
FMO1	drug_target	
PTK6	drug_target	
Aminosalicylic Acid	drug	
PTGS2	drug_target	
MPO	drug_target	
ALOX5	drug_target	
CHUK	drug_target	
PLA2G2E	drug_target	
Interferon beta-1b	drug	
Cyanocobalamin	drug	
MTR	drug_target	
MUT	drug_target	
MTRR	drug_target	
MMAA	drug_target	
MMACHC	drug_target	
MTHFR	drug_target	
MMAB	drug_target	
AMN	drug_target	
TCN1	drug_target	
TCN2	drug_target	
GIF	drug_target	
CUBN	drug_target	
VWF	intermediate	
STAT1	intermediate	
IFNA2	intermediate	
STAT2	intermediate	
TYK2	intermediate	
TRIM24	intermediate	
HRAS	intermediate	
MAPK1	intermediate	
GAB2	intermediate	
AGK	intermediate	
PIK3CA	intermediate	
AKAP9	intermediate	
SHC1	intermediate	
GRIN2B	intermediate	
SOS1	intermediate	
NRAS	intermediate	
GRIN1	intermediate	
PTPN11	intermediate	
PDGFB	intermediate	
BRAF	intermediate	
MAPK3	intermediate	
PECAM1	intermediate	
CDC42	intermediate	
PIK3R1	intermediate	
GRB2	intermediate	
complex:lAo9+jzjVOaRJSWZQvoh0G1mUDc	intermediate	
CFH	intermediate	
NFKB1	intermediate	
NFKB2	intermediate	
ITGA2	intermediate	
APOE	intermediate	
IFIH1	intermediate	
PALB2	intermediate	
CSF2	intermediate	
IL3	intermediate	
ICOS	intermediate	
HLA-DRB1	intermediate	
PTPN22	intermediate	
BTK	intermediate	
PDGFA	intermediate	
PLCG1	intermediate	
KITLG	intermediate	
FRS2	intermediate	
PIK3R2	intermediate	
HGF	intermediate	
HLA-DRB3	intermediate	
PIK3CB	intermediate	
MET	intermediate	
FGF16	intermediate	
NCK1	intermediate	
FGF8	intermediate	
NRG1	intermediate	
HBEGF	intermediate	
KLB	intermediate	
ERBB4	intermediate	
FGF23	intermediate	
FGF18	intermediate	
NRG4	intermediate	
FGF7	intermediate	
GRB7	intermediate	
FGF17	intermediate	
FGF22	intermediate	
CRK	intermediate	
FGF5	intermediate	
EREG	intermediate	
FGF19	intermediate	
FGF3	intermediate	
FGF20	intermediate	
BTC	intermediate	
FGF10	intermediate	
KL	intermediate	
FGF9	intermediate	
FGF6	intermediate	
PTK2	intermediate	
VAV1	intermediate	
LAT	intermediate	
TFRC	intermediate	
CD3G	intermediate	
OCRL	intermediate	
SCARB2	intermediate	
CRKL	intermediate	
HSP90AA1	intermediate	
