Epinephrine	drug	
TNF	drug_target	
CYP1A2	drug_target	
CYP3A4	drug_target	
CYP2C9	drug_target	
PAH	drug_target	
SLC22A2	drug_target	
SLC22A1	drug_target	
SLC22A5	drug_target	
ADRB1	drug_target	
ADRB2	drug_target	
ADRA1A	drug_target	
ADRA1B	drug_target	
ADRA1D	drug_target	
ADRA2A	drug_target	
ADRA2B	drug_target	
ADRA2C	drug_target	
ADRB3	drug_target	
Ventricular tachycardia, catecholaminergic polymorphic, 2	phenotype	
Lisinopril	drug	
ABCB1	drug_target	
ACE	drug_target	
ACE2	drug_target	
RAMP3	intermediate	
IAPP	intermediate	
P2RY11	intermediate	
PTGDR	intermediate	
EDN1	intermediate	
SCT	intermediate	
LHCGR	intermediate	
APP	intermediate	
GPR32	intermediate	
GPR84	intermediate	
complex:lAo9+jzjVOaRJSWZQvoh0G1mUDc	intermediate	
VIP	intermediate	
VIPR1	intermediate	
GNG2	intermediate	
RXFP1	intermediate	
HRH2	intermediate	
GPR83	intermediate	
CALCB	intermediate	
CCL23	intermediate	
GCG	intermediate	
TAAR1	intermediate	
DRD5	intermediate	
PTH	intermediate	
RLN2	intermediate	
TSHB	intermediate	
PTHLH	intermediate	
ADCYAP1R1	intermediate	
GPR45	intermediate	
PTH2R	intermediate	
CALCA	intermediate	
RAMP2	intermediate	
RXFP2	intermediate	
GHRHR	intermediate	
ADM	intermediate	
HTR7	intermediate	
GPR20	intermediate	
GPBAR1	intermediate	
LHB	intermediate	
ADM2	intermediate	
POMC	intermediate	
PMCH	intermediate	
PTGER4	intermediate	
GHRH	intermediate	
GIP	intermediate	
GPR150	intermediate	
MC1R	intermediate	
PTH2	intermediate	
VIPR2	intermediate	
GNB1	intermediate	
CRHR1	intermediate	
GLP2R	intermediate	
CALCR	intermediate	
AGT	intermediate	
GPHA2	intermediate	
PTH1R	intermediate	
GPR176	intermediate	
NPS	intermediate	
RLN3	intermediate	
PTGIR	intermediate	
MC3R	intermediate	
MC2R	intermediate	
CRH	intermediate	
SAA1	intermediate	
CALCRL	intermediate	
ADORA2B	intermediate	
CGA	intermediate	
HTR4	intermediate	
GIPR	intermediate	
MC5R	intermediate	
ADCYAP1	intermediate	
INSL3	intermediate	
GNAS	intermediate	
GCGR	intermediate	
SCN5A	intermediate	
RAMP1	intermediate	
NPSR1	intermediate	
SCTR	intermediate	
GNAI2	intermediate	
GPR27	intermediate	
HTR6	intermediate	
GPR25	intermediate	
FSHR	intermediate	
FSHB	intermediate	
TSHR	intermediate	
GPR15	intermediate	
PTGER2	intermediate	
GPHB5	intermediate	
REN	intermediate	
